"Datum";"Region";"PCR_Pos";"Ag_Neg";"Ag_Pos";"Total";"Pocet.potvrdenych";"Potvrdenych";"newcases";"date";"positive"
2022-06-26;"Banskobystrický kraj";2;1;0;1;NA;91529;2;2022-06-26;91529
2022-06-25;"Banskobystrický kraj";15;0;0;0;NA;91529;15;2022-06-25;91527
2022-06-24;"Banskobystrický kraj";27;115;3;118;NA;91529;30;2022-06-24;91512
2022-06-23;"Banskobystrický kraj";24;591;7;598;NA;91529;31;2022-06-23;91482
2022-06-22;"Banskobystrický kraj";38;91;11;102;NA;91529;49;2022-06-22;91451
2022-06-21;"Banskobystrický kraj";27;120;12;132;NA;91529;39;2022-06-21;91402
2022-06-20;"Banskobystrický kraj";42;230;12;242;NA;91529;54;2022-06-20;91363
2022-06-19;"Banskobystrický kraj";0;39;3;42;NA;91529;3;2022-06-19;91309
2022-06-18;"Banskobystrický kraj";1;3;0;3;NA;91529;1;2022-06-18;91306
2022-06-17;"Banskobystrický kraj";16;105;3;108;NA;91529;19;2022-06-17;91305
2022-06-16;"Banskobystrický kraj";10;168;0;168;NA;91529;10;2022-06-16;91286
2022-06-15;"Banskobystrický kraj";17;117;1;118;NA;91529;18;2022-06-15;91276
2022-06-14;"Banskobystrický kraj";12;552;0;552;NA;91529;12;2022-06-14;91258
2022-06-13;"Banskobystrický kraj";34;229;7;236;NA;91529;41;2022-06-13;91246
2022-06-12;"Banskobystrický kraj";0;45;3;48;NA;91529;3;2022-06-12;91205
2022-06-11;"Banskobystrický kraj";2;2;2;4;NA;91529;4;2022-06-11;91202
2022-06-10;"Banskobystrický kraj";24;148;3;151;NA;91529;27;2022-06-10;91198
2022-06-09;"Banskobystrický kraj";8;320;2;322;NA;91529;10;2022-06-09;91171
2022-06-08;"Banskobystrický kraj";25;292;10;302;NA;91529;35;2022-06-08;91161
2022-06-07;"Banskobystrický kraj";13;323;6;329;NA;91529;19;2022-06-07;91126
2022-06-06;"Banskobystrický kraj";15;987;6;993;NA;91529;21;2022-06-06;91107
2022-06-05;"Banskobystrický kraj";4;35;2;37;NA;91529;6;2022-06-05;91086
2022-06-04;"Banskobystrický kraj";3;18;0;18;NA;91529;3;2022-06-04;91080
2022-06-03;"Banskobystrický kraj";10;257;3;260;NA;91529;13;2022-06-03;91077
2022-06-02;"Banskobystrický kraj";11;564;1;565;NA;91529;12;2022-06-02;91064
2022-06-01;"Banskobystrický kraj";11;351;5;356;NA;91529;16;2022-06-01;91052
2022-05-31;"Banskobystrický kraj";9;319;1;320;NA;91529;10;2022-05-31;91036
2022-05-30;"Banskobystrický kraj";12;788;1;789;NA;91529;13;2022-05-30;91026
2022-05-29;"Banskobystrický kraj";0;33;0;33;NA;91529;0;2022-05-29;91013
2022-05-28;"Banskobystrický kraj";3;11;0;11;NA;91529;3;2022-05-28;91013
2022-05-27;"Banskobystrický kraj";7;230;5;235;NA;91529;12;2022-05-27;91010
2022-05-26;"Banskobystrický kraj";4;281;4;285;NA;91529;8;2022-05-26;90998
2022-05-25;"Banskobystrický kraj";14;236;4;240;NA;91529;18;2022-05-25;90990
2022-05-24;"Banskobystrický kraj";14;253;4;257;NA;91529;18;2022-05-24;90972
2022-05-23;"Banskobystrický kraj";12;552;6;558;NA;91529;18;2022-05-23;90954
2022-05-22;"Banskobystrický kraj";1;32;2;34;NA;91529;3;2022-05-22;90936
2022-05-21;"Banskobystrický kraj";9;13;1;14;NA;91529;10;2022-05-21;90933
2022-05-20;"Banskobystrický kraj";17;199;8;207;NA;91529;25;2022-05-20;90923
2022-05-19;"Banskobystrický kraj";6;384;4;388;NA;91529;10;2022-05-19;90898
2022-05-18;"Banskobystrický kraj";23;210;8;218;NA;91529;31;2022-05-18;90888
2022-05-17;"Banskobystrický kraj";6;295;7;302;NA;91529;13;2022-05-17;90857
2022-05-16;"Banskobystrický kraj";22;620;16;636;NA;91529;38;2022-05-16;90844
2022-05-15;"Banskobystrický kraj";4;27;1;28;NA;91529;5;2022-05-15;90806
2022-05-14;"Banskobystrický kraj";4;17;0;17;NA;91529;4;2022-05-14;90801
2022-05-13;"Banskobystrický kraj";32;324;6;330;NA;91529;38;2022-05-13;90797
2022-05-12;"Banskobystrický kraj";16;517;15;532;NA;91529;31;2022-05-12;90759
2022-05-11;"Banskobystrický kraj";19;376;9;385;NA;91529;28;2022-05-11;90728
2022-05-10;"Banskobystrický kraj";49;268;11;279;NA;91529;60;2022-05-10;90700
2022-05-09;"Banskobystrický kraj";35;714;24;738;NA;91529;59;2022-05-09;90640
2022-05-08;"Banskobystrický kraj";1;64;0;64;NA;91529;1;2022-05-08;90581
2022-05-07;"Banskobystrický kraj";6;111;1;112;NA;91529;7;2022-05-07;90580
2022-05-06;"Banskobystrický kraj";51;278;6;284;NA;91529;57;2022-05-06;90573
2022-05-05;"Banskobystrický kraj";41;556;11;567;NA;91529;52;2022-05-05;90516
2022-05-04;"Banskobystrický kraj";45;498;14;512;NA;91529;59;2022-05-04;90464
2022-05-03;"Banskobystrický kraj";60;421;5;426;NA;91529;65;2022-05-03;90405
2022-05-02;"Banskobystrický kraj";48;1063;38;1101;NA;91529;86;2022-05-02;90340
2022-05-01;"Banskobystrický kraj";12;69;1;70;NA;91529;13;2022-05-01;90254
2022-04-30;"Banskobystrický kraj";31;82;5;87;NA;91529;36;2022-04-30;90241
2022-04-29;"Banskobystrický kraj";57;681;16;697;NA;91529;73;2022-04-29;90205
2022-04-28;"Banskobystrický kraj";72;972;20;992;NA;91529;92;2022-04-28;90132
2022-04-27;"Banskobystrický kraj";85;907;29;936;NA;91529;114;2022-04-27;90040
2022-04-26;"Banskobystrický kraj";97;720;18;738;NA;91529;115;2022-04-26;89926
2022-04-25;"Banskobystrický kraj";148;1463;33;1496;NA;91529;181;2022-04-25;89811
2022-04-24;"Banskobystrický kraj";16;139;5;144;NA;91529;21;2022-04-24;89630
2022-04-23;"Banskobystrický kraj";110;64;9;73;NA;91529;119;2022-04-23;89609
2022-04-22;"Banskobystrický kraj";140;1044;32;1076;NA;91529;172;2022-04-22;89490
2022-04-21;"Banskobystrický kraj";154;1228;41;1269;NA;91529;195;2022-04-21;89318
2022-04-20;"Banskobystrický kraj";243;2052;141;2193;NA;91529;384;2022-04-20;89123
2022-04-19;"Banskobystrický kraj";209;1976;94;2070;NA;91529;303;2022-04-19;88739
2022-04-18;"Banskobystrický kraj";25;113;7;120;NA;91529;32;2022-04-18;88436
2022-04-17;"Banskobystrický kraj";105;54;3;57;NA;91529;108;2022-04-17;88404
2022-04-16;"Banskobystrický kraj";58;96;12;108;NA;91529;70;2022-04-16;88296
2022-04-15;"Banskobystrický kraj";44;106;5;111;NA;91529;49;2022-04-15;88226
2022-04-14;"Banskobystrický kraj";230;1095;31;1126;NA;91529;261;2022-04-14;88177
2022-04-13;"Banskobystrický kraj";212;932;60;992;NA;91529;272;2022-04-13;87916
2022-04-12;"Banskobystrický kraj";242;1066;60;1126;NA;91529;302;2022-04-12;87644
2022-04-11;"Banskobystrický kraj";300;2346;99;2445;NA;91529;399;2022-04-11;87342
2022-04-10;"Banskobystrický kraj";62;260;28;288;NA;91529;90;2022-04-10;86943
2022-04-09;"Banskobystrický kraj";147;112;16;128;NA;91529;163;2022-04-09;86853
2022-04-08;"Banskobystrický kraj";284;1193;95;1288;NA;91529;379;2022-04-08;86690
2022-04-07;"Banskobystrický kraj";298;1622;74;1696;NA;91529;372;2022-04-07;86311
2022-04-06;"Banskobystrický kraj";505;1191;89;1280;NA;91529;594;2022-04-06;85939
2022-04-05;"Banskobystrický kraj";458;1359;84;1443;NA;91529;542;2022-04-05;85345
2022-04-04;"Banskobystrický kraj";553;2810;177;2987;NA;91529;730;2022-04-04;84803
2022-04-03;"Banskobystrický kraj";66;441;83;524;NA;91529;149;2022-04-03;84073
2022-04-02;"Banskobystrický kraj";208;133;34;167;NA;91529;242;2022-04-02;83924
2022-04-01;"Banskobystrický kraj";529;1195;137;1332;NA;91529;666;2022-04-01;83682
2022-03-31;"Banskobystrický kraj";516;1798;102;1900;NA;91529;618;2022-03-31;83016
2022-03-30;"Banskobystrický kraj";734;1541;125;1666;NA;91529;859;2022-03-30;82398
2022-03-29;"Banskobystrický kraj";666;1406;161;1567;NA;91529;827;2022-03-29;81539
2022-03-28;"Banskobystrický kraj";618;2523;318;2841;NA;91529;936;2022-03-28;80712
2022-03-27;"Banskobystrický kraj";147;687;114;801;NA;91529;261;2022-03-27;79776
2022-03-26;"Banskobystrický kraj";343;150;53;203;NA;91529;396;2022-03-26;79515
2022-03-25;"Banskobystrický kraj";721;1382;192;1574;NA;91529;913;2022-03-25;79119
2022-03-24;"Banskobystrický kraj";769;1789;162;1951;NA;91529;931;2022-03-24;78206
2022-03-23;"Banskobystrický kraj";823;1643;201;1844;NA;91529;1024;2022-03-23;77275
2022-03-22;"Banskobystrický kraj";1148;1703;220;1923;NA;91529;1368;2022-03-22;76251
2022-03-21;"Banskobystrický kraj";879;2711;356;3067;NA;91529;1235;2022-03-21;74883
2022-03-20;"Banskobystrický kraj";172;605;174;779;NA;91529;346;2022-03-20;73648
2022-03-19;"Banskobystrický kraj";529;218;89;307;NA;91529;618;2022-03-19;73302
2022-03-18;"Banskobystrický kraj";819;2081;200;2281;NA;91529;1019;2022-03-18;72684
2022-03-17;"Banskobystrický kraj";981;3476;224;3700;NA;91529;1205;2022-03-17;71665
2022-03-16;"Banskobystrický kraj";1189;1396;235;1631;NA;91529;1424;2022-03-16;70460
2022-03-15;"Banskobystrický kraj";1420;1730;231;1961;NA;91529;1651;2022-03-15;69036
2022-03-14;"Banskobystrický kraj";948;3270;426;3696;NA;91529;1374;2022-03-14;67385
2022-03-13;"Banskobystrický kraj";224;577;216;793;NA;91529;440;2022-03-13;66011
2022-03-12;"Banskobystrický kraj";625;262;94;356;NA;91529;719;2022-03-12;65571
2022-03-11;"Banskobystrický kraj";1144;1817;287;2104;NA;91529;1431;2022-03-11;64852
2022-03-10;"Banskobystrický kraj";1325;2126;311;2437;NA;91529;1636;2022-03-10;63421
2022-03-09;"Banskobystrický kraj";1370;2036;333;2369;NA;91529;1703;2022-03-09;61785
2022-03-08;"Banskobystrický kraj";1738;2329;376;2705;NA;91529;2114;2022-03-08;60082
2022-03-07;"Banskobystrický kraj";1048;4977;604;5581;NA;91529;1652;2022-03-07;57968
2022-03-06;"Banskobystrický kraj";356;1265;278;1543;NA;91529;634;2022-03-06;56316
2022-03-05;"Banskobystrický kraj";745;497;180;677;NA;91529;925;2022-03-05;55682
2022-03-04;"Banskobystrický kraj";1302;2576;391;2967;NA;91529;1693;2022-03-04;54757
2022-03-03;"Banskobystrický kraj";1766;3466;386;3852;NA;91529;2152;2022-03-03;53064
2022-03-02;"Banskobystrický kraj";1515;5604;415;6019;NA;91529;1930;2022-03-02;50912
2022-03-01;"Banskobystrický kraj";1842;3325;396;3721;NA;91529;2238;2022-03-01;48982
2022-02-28;"Banskobystrický kraj";1050;4913;708;5621;NA;91529;1758;2022-02-28;46744
2022-02-27;"Banskobystrický kraj";604;1162;303;1465;NA;91529;907;2022-02-27;44986
2022-02-26;"Banskobystrický kraj";909;528;154;682;NA;91529;1063;2022-02-26;44079
2022-02-25;"Banskobystrický kraj";1591;2519;430;2949;NA;91529;2021;2022-02-25;43016
2022-02-24;"Banskobystrický kraj";1781;3858;404;4262;NA;91529;2185;2022-02-24;40995
2022-02-23;"Banskobystrický kraj";2094;2869;454;3323;NA;91529;2548;2022-02-23;38810
2022-02-22;"Banskobystrický kraj";2195;3737;469;4206;NA;91529;2664;2022-02-22;36262
2022-02-21;"Banskobystrický kraj";1409;5733;806;6539;NA;91529;2215;2022-02-21;33598
2022-02-20;"Banskobystrický kraj";484;1717;423;2140;NA;91529;907;2022-02-20;31383
2022-02-19;"Banskobystrický kraj";1180;774;242;1016;NA;91529;1422;2022-02-19;30476
2022-02-18;"Banskobystrický kraj";2473;3620;541;4161;NA;91529;3014;2022-02-18;29054
2022-02-17;"Banskobystrický kraj";1924;4324;460;4784;NA;91529;2384;2022-02-17;26040
2022-02-16;"Banskobystrický kraj";1856;3635;543;4178;NA;91529;2399;2022-02-16;23656
2022-02-15;"Banskobystrický kraj";2287;4460;584;5044;NA;91529;2871;2022-02-15;21257
2022-02-14;"Banskobystrický kraj";2071;6848;891;7739;NA;91529;2962;2022-02-14;18386
2022-02-13;"Banskobystrický kraj";577;2247;471;2718;NA;91529;1048;2022-02-13;15424
2022-02-12;"Banskobystrický kraj";1308;906;308;1214;NA;91529;1616;2022-02-12;14376
2022-02-11;"Banskobystrický kraj";2684;3845;555;4400;NA;91529;3239;2022-02-11;12760
2022-02-10;"Banskobystrický kraj";1765;5733;567;6300;NA;91529;2332;2022-02-10;9521
2022-02-09;"Banskobystrický kraj";2544;3794;569;4363;NA;91529;3113;2022-02-09;7189
2022-02-08;"Banskobystrický kraj";1806;4418;538;4956;NA;91529;2344;2022-02-08;4076
2022-02-07;"Banskobystrický kraj";1683;7388;728;8116;NA;91529;2411;2022-02-07;1732
2022-02-06;"Banskobystrický kraj";604;2244;392;2636;NA;91529;996;2022-02-06;-679
2022-02-05;"Banskobystrický kraj";1032;1434;233;1667;NA;91529;1265;2022-02-05;-1675
2022-02-04;"Banskobystrický kraj";1866;3745;438;4183;NA;91529;2304;2022-02-04;-2940
2022-02-03;"Banskobystrický kraj";1561;5433;359;5792;NA;91529;1920;2022-02-03;-5244
2022-02-02;"Banskobystrický kraj";1716;4793;395;5188;NA;91529;2111;2022-02-02;-7164
2022-02-01;"Banskobystrický kraj";1918;4558;410;4968;NA;91529;2328;2022-02-01;-9275
2022-01-31;"Banskobystrický kraj";779;9006;553;9559;NA;91529;1332;2022-01-31;-11603
2022-01-30;"Banskobystrický kraj";412;3055;267;3322;NA;91529;679;2022-01-30;-12935
2022-01-29;"Banskobystrický kraj";981;1155;174;1329;NA;91529;1155;2022-01-29;-13614
2022-01-28;"Banskobystrický kraj";1040;3814;313;4127;NA;91529;1353;2022-01-28;-14769
2022-01-27;"Banskobystrický kraj";1035;4955;225;5180;NA;91529;1260;2022-01-27;-16122
2022-01-26;"Banskobystrický kraj";1060;4035;213;4248;NA;91529;1273;2022-01-26;-17382
2022-01-25;"Banskobystrický kraj";1001;6119;257;6376;NA;91529;1258;2022-01-25;-18655
2022-01-24;"Banskobystrický kraj";557;10186;257;10443;NA;91529;814;2022-01-24;-19913
2022-01-23;"Banskobystrický kraj";246;3710;129;3839;NA;91529;375;2022-01-23;-20727
2022-01-22;"Banskobystrický kraj";411;1077;64;1141;NA;91529;475;2022-01-22;-21102
2022-01-21;"Banskobystrický kraj";578;3491;113;3604;NA;91529;691;2022-01-21;-21577
2022-01-20;"Banskobystrický kraj";490;3810;91;3901;NA;91529;581;2022-01-20;-22268
2022-01-19;"Banskobystrický kraj";421;4173;98;4271;NA;91529;519;2022-01-19;-22849
2022-01-18;"Banskobystrický kraj";517;4737;95;4832;NA;91529;612;2022-01-18;-23368
2022-01-17;"Banskobystrický kraj";269;8102;114;8216;NA;91529;383;2022-01-17;-23980
2022-01-16;"Banskobystrický kraj";63;2746;84;2830;NA;91529;147;2022-01-16;-24363
2022-01-15;"Banskobystrický kraj";287;858;16;874;NA;91529;303;2022-01-15;-24510
2022-01-14;"Banskobystrický kraj";165;2758;67;2825;NA;91529;232;2022-01-14;-24813
2022-01-13;"Banskobystrický kraj";182;3411;57;3468;NA;91529;239;2022-01-13;-25045
2022-01-12;"Banskobystrický kraj";241;3787;67;3854;NA;91529;308;2022-01-12;-25284
2022-01-11;"Banskobystrický kraj";327;4970;74;5044;NA;91529;401;2022-01-11;-25592
2022-01-10;"Banskobystrický kraj";219;8173;113;8286;NA;91529;332;2022-01-10;-25993
2022-01-09;"Banskobystrický kraj";54;3514;38;3552;NA;91529;92;2022-01-09;-26325
2022-01-08;"Banskobystrický kraj";177;1054;40;1094;NA;91529;217;2022-01-08;-26417
2022-01-07;"Banskobystrický kraj";320;3087;86;3173;NA;91529;406;2022-01-07;-26634
2022-01-06;"Banskobystrický kraj";101;985;21;1006;NA;91529;122;2022-01-06;-27040
2022-01-05;"Banskobystrický kraj";376;2852;67;2919;NA;91529;443;2022-01-05;-27162
2022-01-04;"Banskobystrický kraj";458;4197;72;4269;NA;91529;530;2022-01-04;-27605
2022-01-03;"Banskobystrický kraj";420;8216;115;8331;NA;91529;535;2022-01-03;-28135
2022-01-02;"Banskobystrický kraj";117;2239;95;2334;NA;91529;212;2022-01-02;-28670
2022-01-01;"Banskobystrický kraj";33;112;4;116;NA;91529;37;2022-01-01;-28882
2021-12-31;"Banskobystrický kraj";314;1803;68;1871;NA;91529;382;2021-12-31;-28919
2021-12-30;"Banskobystrický kraj";308;2833;88;2921;NA;91529;396;2021-12-30;-29301
2021-12-29;"Banskobystrický kraj";390;2448;83;2531;NA;91529;473;2021-12-29;-29697
2021-12-28;"Banskobystrický kraj";492;2902;95;2997;NA;91529;587;2021-12-28;-30170
2021-12-27;"Banskobystrický kraj";397;5029;203;5232;NA;91529;600;2021-12-27;-30757
2021-12-26;"Banskobystrický kraj";76;1245;62;1307;NA;91529;138;2021-12-26;-31357
2021-12-25;"Banskobystrický kraj";107;373;45;418;NA;91529;152;2021-12-25;-31495
2021-12-24;"Banskobystrický kraj";116;213;10;223;NA;91529;126;2021-12-24;-31647
2021-12-23;"Banskobystrický kraj";429;3501;107;3608;NA;91529;536;2021-12-23;-31773
2021-12-22;"Banskobystrický kraj";393;3394;106;3500;NA;91529;499;2021-12-22;-32309
2021-12-21;"Banskobystrický kraj";508;4173;88;4261;NA;91529;596;2021-12-21;-32808
2021-12-20;"Banskobystrický kraj";424;7610;186;7796;NA;91529;610;2021-12-20;-33404
2021-12-19;"Banskobystrický kraj";39;2681;87;2768;NA;91529;126;2021-12-19;-34014
2021-12-18;"Banskobystrický kraj";333;1036;67;1103;NA;91529;400;2021-12-18;-34140
2021-12-17;"Banskobystrický kraj";465;3805;102;3907;NA;91529;567;2021-12-17;-34540
2021-12-16;"Banskobystrický kraj";499;4278;116;4394;NA;91529;615;2021-12-16;-35107
2021-12-15;"Banskobystrický kraj";554;4772;102;4874;NA;91529;656;2021-12-15;-35722
2021-12-14;"Banskobystrický kraj";729;4614;108;4722;NA;91529;837;2021-12-14;-36378
2021-12-13;"Banskobystrický kraj";470;8201;222;8423;NA;91529;692;2021-12-13;-37215
2021-12-12;"Banskobystrický kraj";161;3332;101;3433;NA;91529;262;2021-12-12;-37907
2021-12-11;"Banskobystrický kraj";568;1166;82;1248;NA;91529;650;2021-12-11;-38169
2021-12-10;"Banskobystrický kraj";731;4033;185;4218;NA;91529;916;2021-12-10;-38819
2021-12-09;"Banskobystrický kraj";652;4381;139;4520;NA;91529;791;2021-12-09;-39735
2021-12-08;"Banskobystrický kraj";1087;4100;169;4269;NA;91529;1256;2021-12-08;-40526
2021-12-07;"Banskobystrický kraj";1104;5410;201;5611;NA;91529;1305;2021-12-07;-41782
2021-12-06;"Banskobystrický kraj";647;9113;324;9437;NA;91529;971;2021-12-06;-43087
2021-12-05;"Banskobystrický kraj";217;3425;155;3580;NA;91529;372;2021-12-05;-44058
2021-12-04;"Banskobystrický kraj";654;1334;131;1465;NA;91529;785;2021-12-04;-44430
2021-12-03;"Banskobystrický kraj";1117;5057;246;5303;NA;91529;1363;2021-12-03;-45215
2021-12-02;"Banskobystrický kraj";1710;5259;258;5517;NA;91529;1968;2021-12-02;-46578
2021-12-01;"Banskobystrický kraj";947;4753;264;5017;NA;91529;1211;2021-12-01;-48546
2021-11-30;"Banskobystrický kraj";1266;6543;245;6788;NA;91529;1511;2021-11-30;-49757
2021-11-29;"Banskobystrický kraj";591;10653;468;11121;NA;91529;1059;2021-11-29;-51268
2021-11-28;"Banskobystrický kraj";418;4289;216;4505;NA;91529;634;2021-11-28;-52327
2021-11-27;"Banskobystrický kraj";827;1781;208;1989;NA;91529;1035;2021-11-27;-52961
2021-11-26;"Banskobystrický kraj";963;4771;354;5125;NA;91529;1317;2021-11-26;-53996
2021-11-25;"Banskobystrický kraj";1110;5911;350;6261;NA;91529;1460;2021-11-25;-55313
2021-11-24;"Banskobystrický kraj";1387;5956;330;6286;NA;91529;1717;2021-11-24;-56773
2021-11-23;"Banskobystrický kraj";1436;6082;377;6459;NA;91529;1813;2021-11-23;-58490
2021-11-22;"Banskobystrický kraj";489;8727;579;9306;NA;91529;1068;2021-11-22;-60303
2021-11-21;"Banskobystrický kraj";408;4109;307;4416;NA;91529;715;2021-11-21;-61371
2021-11-20;"Banskobystrický kraj";985;1758;199;1957;NA;91529;1184;2021-11-20;-62086
2021-11-19;"Banskobystrický kraj";1006;4886;470;5356;NA;91529;1476;2021-11-19;-63270
2021-11-18;"Banskobystrický kraj";979;8037;620;8657;NA;91529;1599;2021-11-18;-64746
2021-11-17;"Banskobystrický kraj";772;1051;147;1198;NA;91529;919;2021-11-17;-66345
2021-11-16;"Banskobystrický kraj";1130;5473;453;5926;NA;91529;1583;2021-11-16;-67264
2021-11-15;"Banskobystrický kraj";749;7884;588;8472;NA;91529;1337;2021-11-15;-68847
2021-11-14;"Banskobystrický kraj";311;2629;302;2931;NA;91529;613;2021-11-14;-70184
2021-11-13;"Banskobystrický kraj";761;1471;214;1685;NA;91529;975;2021-11-13;-70797
2021-11-12;"Banskobystrický kraj";972;5019;434;5453;NA;91529;1406;2021-11-12;-71772
2021-11-11;"Banskobystrický kraj";1023;5584;345;5929;NA;91529;1368;2021-11-11;-73178
2021-11-10;"Banskobystrický kraj";950;4713;333;5046;NA;91529;1283;2021-11-10;-74546
2021-11-09;"Banskobystrický kraj";921;4616;283;4899;NA;91529;1204;2021-11-09;-75829
2021-11-08;"Banskobystrický kraj";519;7249;488;7737;NA;91529;1007;2021-11-08;-77033
2021-11-07;"Banskobystrický kraj";460;2479;258;2737;NA;91529;718;2021-11-07;-78040
2021-11-06;"Banskobystrický kraj";505;1344;170;1514;NA;91529;675;2021-11-06;-78758
2021-11-05;"Banskobystrický kraj";997;4773;342;5115;NA;91529;1339;2021-11-05;-79433
2021-11-04;"Banskobystrický kraj";1086;4811;248;5059;NA;91529;1334;2021-11-04;-80772
2021-11-03;"Banskobystrický kraj";976;4825;330;5155;NA;91529;1306;2021-11-03;-82106
2021-11-02;"Banskobystrický kraj";538;5709;492;6201;NA;91529;1030;2021-11-02;-83412
2021-11-01;"Banskobystrický kraj";390;1178;132;1310;NA;91529;522;2021-11-01;-84442
2021-10-31;"Banskobystrický kraj";150;1700;210;1910;NA;91529;360;2021-10-31;-84964
2021-10-30;"Banskobystrický kraj";449;1508;140;1648;NA;91529;589;2021-10-30;-85324
2021-10-29;"Banskobystrický kraj";780;4178;286;4464;NA;91529;1066;2021-10-29;-85913
2021-10-28;"Banskobystrický kraj";744;4182;247;4429;NA;91529;991;2021-10-28;-86979
2021-10-27;"Banskobystrický kraj";664;4577;233;4810;NA;91529;897;2021-10-27;-87970
2021-10-26;"Banskobystrický kraj";700;3673;187;3860;NA;91529;887;2021-10-26;-88867
2021-10-25;"Banskobystrický kraj";376;5478;257;5735;NA;91529;633;2021-10-25;-89754
2021-10-24;"Banskobystrický kraj";161;1707;143;1850;NA;91529;304;2021-10-24;-90387
2021-10-23;"Banskobystrický kraj";238;1286;79;1365;NA;91529;317;2021-10-23;-90691
2021-10-22;"Banskobystrický kraj";530;3816;185;4001;NA;91529;715;2021-10-22;-91008
2021-10-21;"Banskobystrický kraj";416;4128;140;4268;NA;91529;556;2021-10-21;-91723
2021-10-20;"Banskobystrický kraj";387;3615;123;3738;NA;91529;510;2021-10-20;-92279
2021-10-19;"Banskobystrický kraj";419;4094;103;4197;NA;91529;522;2021-10-19;-92789
2021-10-18;"Banskobystrický kraj";162;5286;175;5461;NA;91529;337;2021-10-18;-93311
2021-10-17;"Banskobystrický kraj";26;1555;71;1626;NA;91529;97;2021-10-17;-93648
2021-10-16;"Banskobystrický kraj";162;1387;50;1437;NA;91529;212;2021-10-16;-93745
2021-10-15;"Banskobystrický kraj";187;3693;81;3774;NA;91529;268;2021-10-15;-93957
2021-10-14;"Banskobystrický kraj";198;3705;47;3752;NA;91529;245;2021-10-14;-94225
2021-10-13;"Banskobystrický kraj";217;3068;55;3123;NA;91529;272;2021-10-13;-94470
2021-10-12;"Banskobystrický kraj";301;3743;59;3802;NA;91529;360;2021-10-12;-94742
2021-10-11;"Banskobystrický kraj";128;4734;96;4830;NA;91529;224;2021-10-11;-95102
2021-10-10;"Banskobystrický kraj";26;1815;53;1868;NA;91529;79;2021-10-10;-95326
2021-10-09;"Banskobystrický kraj";73;1122;27;1149;NA;91529;100;2021-10-09;-95405
2021-10-08;"Banskobystrický kraj";239;3027;61;3088;NA;91529;300;2021-10-08;-95505
2021-10-07;"Banskobystrický kraj";179;3437;42;3479;NA;91529;221;2021-10-07;-95805
2021-10-06;"Banskobystrický kraj";136;3862;48;3910;NA;91529;184;2021-10-06;-96026
2021-10-05;"Banskobystrický kraj";209;2979;54;3033;NA;91529;263;2021-10-05;-96210
2021-10-04;"Banskobystrický kraj";126;3725;64;3789;NA;91529;190;2021-10-04;-96473
2021-10-03;"Banskobystrický kraj";11;1407;34;1441;NA;91529;45;2021-10-03;-96663
2021-10-02;"Banskobystrický kraj";66;1042;26;1068;NA;91529;92;2021-10-02;-96708
2021-10-01;"Banskobystrický kraj";158;3228;51;3279;NA;91529;209;2021-10-01;-96800
2021-09-30;"Banskobystrický kraj";120;3362;30;3392;NA;91529;150;2021-09-30;-97009
2021-09-29;"Banskobystrický kraj";118;2626;40;2666;NA;91529;158;2021-09-29;-97159
2021-09-28;"Banskobystrický kraj";112;3061;45;3106;NA;91529;157;2021-09-28;-97317
2021-09-27;"Banskobystrický kraj";90;4456;72;4528;NA;91529;162;2021-09-27;-97474
2021-09-26;"Banskobystrický kraj";17;1498;31;1529;NA;91529;48;2021-09-26;-97636
2021-09-25;"Banskobystrický kraj";17;1481;7;1488;NA;91529;24;2021-09-25;-97684
2021-09-24;"Banskobystrický kraj";98;4254;32;4286;NA;91529;130;2021-09-24;-97708
2021-09-23;"Banskobystrický kraj";63;3019;13;3032;NA;91529;76;2021-09-23;-97838
2021-09-22;"Banskobystrický kraj";75;2442;19;2461;NA;91529;94;2021-09-22;-97914
2021-09-21;"Banskobystrický kraj";125;2976;20;2996;NA;91529;145;2021-09-21;-98008
2021-09-20;"Banskobystrický kraj";45;3951;30;3981;NA;91529;75;2021-09-20;-98153
2021-09-19;"Banskobystrický kraj";6;1456;24;1480;NA;91529;30;2021-09-19;-98228
2021-09-18;"Banskobystrický kraj";44;1318;15;1333;NA;91529;59;2021-09-18;-98258
2021-09-17;"Banskobystrický kraj";73;3485;32;3517;NA;91529;105;2021-09-17;-98317
2021-09-16;"Banskobystrický kraj";95;3019;29;3048;NA;91529;124;2021-09-16;-98422
2021-09-15;"Banskobystrický kraj";22;394;1;395;NA;91529;23;2021-09-15;-98546
2021-09-14;"Banskobystrický kraj";95;2508;28;2536;NA;91529;123;2021-09-14;-98569
2021-09-13;"Banskobystrický kraj";29;3206;28;3234;NA;91529;57;2021-09-13;-98692
2021-09-12;"Banskobystrický kraj";7;958;15;973;NA;91529;22;2021-09-12;-98749
2021-09-11;"Banskobystrický kraj";31;865;11;876;NA;91529;42;2021-09-11;-98771
2021-09-10;"Banskobystrický kraj";59;2250;24;2274;NA;91529;83;2021-09-10;-98813
2021-09-09;"Banskobystrický kraj";46;2011;17;2028;NA;91529;63;2021-09-09;-98896
2021-09-08;"Banskobystrický kraj";46;1713;27;1740;NA;91529;73;2021-09-08;-98959
2021-09-07;"Banskobystrický kraj";27;1422;21;1443;NA;91529;48;2021-09-07;-99032
2021-09-06;"Banskobystrický kraj";26;2570;13;2583;NA;91529;39;2021-09-06;-99080
2021-09-05;"Banskobystrický kraj";9;742;2;744;NA;91529;11;2021-09-05;-99119
2021-09-04;"Banskobystrický kraj";14;745;10;755;NA;91529;24;2021-09-04;-99130
2021-09-03;"Banskobystrický kraj";49;2116;22;2138;NA;91529;71;2021-09-03;-99154
2021-09-02;"Banskobystrický kraj";19;1730;25;1755;NA;91529;44;2021-09-02;-99225
2021-09-01;"Banskobystrický kraj";6;230;6;236;NA;91529;12;2021-09-01;-99269
2021-08-31;"Banskobystrický kraj";18;1406;13;1419;NA;91529;31;2021-08-31;-99281
2021-08-30;"Banskobystrický kraj";23;1867;10;1877;NA;91529;33;2021-08-30;-99312
2021-08-29;"Banskobystrický kraj";0;351;5;356;NA;91529;5;2021-08-29;-99345
2021-08-28;"Banskobystrický kraj";9;827;5;832;NA;91529;14;2021-08-28;-99350
2021-08-27;"Banskobystrický kraj";7;1608;12;1620;NA;91529;19;2021-08-27;-99364
2021-08-26;"Banskobystrický kraj";7;1161;2;1163;NA;91529;9;2021-08-26;-99383
2021-08-25;"Banskobystrický kraj";6;1052;1;1053;NA;91529;7;2021-08-25;-99392
2021-08-24;"Banskobystrický kraj";12;1117;1;1118;NA;91529;13;2021-08-24;-99399
2021-08-23;"Banskobystrický kraj";7;1368;5;1373;NA;91529;12;2021-08-23;-99412
2021-08-22;"Banskobystrický kraj";0;773;2;775;NA;91529;2;2021-08-22;-99424
2021-08-21;"Banskobystrický kraj";3;793;1;794;NA;91529;4;2021-08-21;-99426
2021-08-20;"Banskobystrický kraj";5;1616;4;1620;NA;91529;9;2021-08-20;-99430
2021-08-19;"Banskobystrický kraj";4;1092;3;1095;NA;91529;7;2021-08-19;-99439
2021-08-18;"Banskobystrický kraj";1;1044;1;1045;NA;91529;2;2021-08-18;-99446
2021-08-17;"Banskobystrický kraj";12;890;0;890;NA;91529;12;2021-08-17;-99448
2021-08-16;"Banskobystrický kraj";7;1321;3;1324;NA;91529;10;2021-08-16;-99460
2021-08-15;"Banskobystrický kraj";0;366;3;369;NA;91529;3;2021-08-15;-99470
2021-08-14;"Banskobystrický kraj";6;435;1;436;NA;91529;7;2021-08-14;-99473
2021-08-13;"Banskobystrický kraj";11;898;0;898;NA;91529;11;2021-08-13;-99480
2021-08-12;"Banskobystrický kraj";10;951;1;952;NA;91529;11;2021-08-12;-99491
2021-08-11;"Banskobystrický kraj";7;575;3;578;NA;91529;10;2021-08-11;-99502
2021-08-10;"Banskobystrický kraj";7;678;2;680;NA;91529;9;2021-08-10;-99512
2021-08-09;"Banskobystrický kraj";9;1064;0;1064;NA;91529;9;2021-08-09;-99521
2021-08-08;"Banskobystrický kraj";4;335;1;336;NA;91529;5;2021-08-08;-99530
2021-08-07;"Banskobystrický kraj";0;308;4;312;NA;91529;4;2021-08-07;-99535
2021-08-06;"Banskobystrický kraj";5;929;2;931;NA;91529;7;2021-08-06;-99539
2021-08-05;"Banskobystrický kraj";2;838;1;839;NA;91529;3;2021-08-05;-99546
2021-08-04;"Banskobystrický kraj";2;579;1;580;NA;91529;3;2021-08-04;-99549
2021-08-03;"Banskobystrický kraj";4;743;0;743;NA;91529;4;2021-08-03;-99552
2021-08-02;"Banskobystrický kraj";6;934;0;934;NA;91529;6;2021-08-02;-99556
2021-08-01;"Banskobystrický kraj";0;271;0;271;NA;91529;0;2021-08-01;-99562
2021-07-31;"Banskobystrický kraj";1;370;4;374;NA;91529;5;2021-07-31;-99562
2021-07-30;"Banskobystrický kraj";27;928;2;930;NA;91529;29;2021-07-30;-99567
2021-07-29;"Banskobystrický kraj";2;890;1;891;NA;91529;3;2021-07-29;-99596
2021-07-28;"Banskobystrický kraj";4;520;1;521;NA;91529;5;2021-07-28;-99599
2021-07-27;"Banskobystrický kraj";15;1092;0;1092;NA;91529;15;2021-07-27;-99604
2021-07-26;"Banskobystrický kraj";2;911;1;912;NA;91529;3;2021-07-26;-99619
2021-07-25;"Banskobystrický kraj";0;367;1;368;NA;91529;1;2021-07-25;-99622
2021-07-24;"Banskobystrický kraj";2;298;0;298;NA;91529;2;2021-07-24;-99623
2021-07-23;"Banskobystrický kraj";7;840;0;840;NA;91529;7;2021-07-23;-99625
2021-07-22;"Banskobystrický kraj";5;727;3;730;NA;91529;8;2021-07-22;-99632
2021-07-21;"Banskobystrický kraj";2;560;0;560;NA;91529;2;2021-07-21;-99640
2021-07-20;"Banskobystrický kraj";6;885;2;887;NA;91529;8;2021-07-20;-99642
2021-07-19;"Banskobystrický kraj";1;854;3;857;NA;91529;4;2021-07-19;-99650
2021-07-18;"Banskobystrický kraj";0;377;1;378;NA;91529;1;2021-07-18;-99654
2021-07-17;"Banskobystrický kraj";1;324;0;324;NA;91529;1;2021-07-17;-99655
2021-07-16;"Banskobystrický kraj";3;974;1;975;NA;91529;4;2021-07-16;-99656
2021-07-15;"Banskobystrický kraj";1;1038;0;1038;NA;91529;1;2021-07-15;-99660
2021-07-14;"Banskobystrický kraj";3;765;0;765;NA;91529;3;2021-07-14;-99661
2021-07-13;"Banskobystrický kraj";2;695;0;695;NA;91529;2;2021-07-13;-99664
2021-07-12;"Banskobystrický kraj";1;1057;0;1057;NA;91529;1;2021-07-12;-99666
2021-07-11;"Banskobystrický kraj";0;446;0;446;NA;91529;0;2021-07-11;-99667
2021-07-10;"Banskobystrický kraj";2;368;0;368;NA;91529;2;2021-07-10;-99667
2021-07-09;"Banskobystrický kraj";3;1209;0;1209;NA;91529;3;2021-07-09;-99669
2021-07-08;"Banskobystrický kraj";0;1083;1;1084;NA;91529;1;2021-07-08;-99672
2021-07-07;"Banskobystrický kraj";1;798;0;798;NA;91529;1;2021-07-07;-99673
2021-07-06;"Banskobystrický kraj";6;1365;0;1365;NA;91529;6;2021-07-06;-99674
2021-07-05;"Banskobystrický kraj";2;392;1;393;NA;91529;3;2021-07-05;-99680
2021-07-04;"Banskobystrický kraj";0;318;0;318;NA;91529;0;2021-07-04;-99683
2021-07-03;"Banskobystrický kraj";1;413;1;414;NA;91529;2;2021-07-03;-99683
2021-07-02;"Banskobystrický kraj";3;1045;0;1045;NA;91529;3;2021-07-02;-99685
2021-07-01;"Banskobystrický kraj";0;705;1;706;NA;91529;1;2021-07-01;-99688
2021-06-30;"Banskobystrický kraj";3;7607;1;7608;NA;91529;4;2021-06-30;-99689
2021-06-29;"Banskobystrický kraj";2;4642;1;4643;NA;91529;3;2021-06-29;-99693
2021-06-28;"Banskobystrický kraj";3;5695;1;5696;NA;91529;4;2021-06-28;-99696
2021-06-27;"Banskobystrický kraj";0;4369;5;4374;NA;91529;5;2021-06-27;-99700
2021-06-26;"Banskobystrický kraj";0;4289;4;4293;NA;91529;4;2021-06-26;-99705
2021-06-25;"Banskobystrický kraj";2;6717;2;6719;NA;91529;4;2021-06-25;-99709
2021-06-24;"Banskobystrický kraj";6;4585;2;4587;NA;91529;8;2021-06-24;-99713
2021-06-23;"Banskobystrický kraj";4;4947;0;4947;NA;91529;4;2021-06-23;-99721
2021-06-22;"Banskobystrický kraj";7;4527;0;4527;NA;91529;7;2021-06-22;-99725
2021-06-21;"Banskobystrický kraj";6;5836;8;5844;NA;91529;14;2021-06-21;-99732
2021-06-20;"Banskobystrický kraj";0;5055;7;5062;NA;91529;7;2021-06-20;-99746
2021-06-19;"Banskobystrický kraj";0;5639;4;5643;NA;91529;4;2021-06-19;-99753
2021-06-18;"Banskobystrický kraj";4;7642;1;7643;NA;91529;5;2021-06-18;-99757
2021-06-17;"Banskobystrický kraj";2;5245;3;5248;NA;91529;5;2021-06-17;-99762
2021-06-16;"Banskobystrický kraj";10;5951;5;5956;NA;91529;15;2021-06-16;-99767
2021-06-15;"Banskobystrický kraj";9;5576;6;5582;NA;91529;15;2021-06-15;-99782
2021-06-14;"Banskobystrický kraj";8;6922;7;6929;NA;91529;15;2021-06-14;-99797
2021-06-13;"Banskobystrický kraj";0;6407;7;6414;NA;91529;7;2021-06-13;-99812
2021-06-12;"Banskobystrický kraj";3;6338;6;6344;NA;91529;9;2021-06-12;-99819
2021-06-11;"Banskobystrický kraj";5;9693;15;9708;NA;91529;20;2021-06-11;-99828
2021-06-10;"Banskobystrický kraj";10;5726;8;5734;NA;91529;18;2021-06-10;-99848
2021-06-09;"Banskobystrický kraj";9;5720;4;5724;NA;91529;13;2021-06-09;-99866
2021-06-08;"Banskobystrický kraj";15;5645;10;5655;NA;91529;25;2021-06-08;-99879
2021-06-07;"Banskobystrický kraj";4;7582;21;7603;NA;91529;25;2021-06-07;-99904
2021-06-06;"Banskobystrický kraj";1;7497;12;7509;NA;91529;13;2021-06-06;-99929
2021-06-05;"Banskobystrický kraj";15;7531;9;7540;NA;91529;24;2021-06-05;-99942
2021-06-04;"Banskobystrický kraj";2;9352;14;9366;NA;91529;16;2021-06-04;-99966
2021-06-03;"Banskobystrický kraj";8;6507;24;6531;NA;91529;32;2021-06-03;-99982
2021-06-02;"Banskobystrický kraj";7;6837;6;6843;NA;91529;13;2021-06-02;-100014
2021-06-01;"Banskobystrický kraj";12;7146;14;7160;NA;91529;26;2021-06-01;-100027
2021-05-31;"Banskobystrický kraj";4;9546;31;9577;NA;91529;35;2021-05-31;-100053
2021-05-30;"Banskobystrický kraj";3;8959;19;8978;NA;91529;22;2021-05-30;-100088
2021-05-29;"Banskobystrický kraj";11;9763;18;9781;NA;91529;29;2021-05-29;-100110
2021-05-28;"Banskobystrický kraj";13;11908;27;11935;NA;91529;40;2021-05-28;-100139
2021-05-27;"Banskobystrický kraj";7;8760;12;8772;NA;91529;19;2021-05-27;-100179
2021-05-26;"Banskobystrický kraj";18;7905;17;7922;NA;91529;35;2021-05-26;-100198
2021-05-25;"Banskobystrický kraj";27;8951;30;8981;NA;91529;57;2021-05-25;-100233
2021-05-24;"Banskobystrický kraj";9;12472;44;12516;NA;91529;53;2021-05-24;-100290
2021-05-23;"Banskobystrický kraj";0;9798;27;9825;NA;91529;27;2021-05-23;-100343
2021-05-22;"Banskobystrický kraj";20;9608;26;9634;NA;91529;46;2021-05-22;-100370
2021-05-21;"Banskobystrický kraj";22;12796;25;12821;NA;91529;47;2021-05-21;-100416
2021-05-20;"Banskobystrický kraj";14;8994;25;9019;NA;91529;39;2021-05-20;-100463
2021-05-19;"Banskobystrický kraj";42;8608;21;8629;NA;91529;63;2021-05-19;-100502
2021-05-18;"Banskobystrický kraj";27;9450;25;9475;NA;91529;52;2021-05-18;-100565
2021-05-17;"Banskobystrický kraj";11;13399;33;13432;NA;91529;44;2021-05-17;-100617
2021-05-16;"Banskobystrický kraj";15;14072;26;14098;NA;91529;41;2021-05-16;-100661
2021-05-15;"Banskobystrický kraj";11;15356;29;15385;NA;91529;40;2021-05-15;-100702
2021-05-14;"Banskobystrický kraj";35;18939;45;18984;NA;91529;80;2021-05-14;-100742
2021-05-13;"Banskobystrický kraj";37;10605;40;10645;NA;91529;77;2021-05-13;-100822
2021-05-12;"Banskobystrický kraj";31;10860;45;10905;NA;91529;76;2021-05-12;-100899
2021-05-11;"Banskobystrický kraj";42;11328;48;11376;NA;91529;90;2021-05-11;-100975
2021-05-10;"Banskobystrický kraj";28;17621;68;17689;NA;91529;96;2021-05-10;-101065
2021-05-09;"Banskobystrický kraj";25;21902;68;21970;NA;91529;93;2021-05-09;-101161
2021-05-08;"Banskobystrický kraj";11;14285;26;14311;NA;91529;37;2021-05-08;-101254
2021-05-07;"Banskobystrický kraj";41;21809;78;21887;NA;91529;119;2021-05-07;-101291
2021-05-06;"Banskobystrický kraj";36;12254;70;12324;NA;91529;106;2021-05-06;-101410
2021-05-05;"Banskobystrický kraj";34;12595;63;12658;NA;91529;97;2021-05-05;-101516
2021-05-04;"Banskobystrický kraj";83;13888;47;13935;NA;91529;130;2021-05-04;-101613
2021-05-03;"Banskobystrický kraj";30;20875;80;20955;NA;91529;110;2021-05-03;-101743
2021-05-02;"Banskobystrický kraj";6;33040;60;33100;NA;91529;66;2021-05-02;-101853
2021-05-01;"Banskobystrický kraj";54;36903;67;36970;NA;91529;121;2021-05-01;-101919
2021-04-30;"Banskobystrický kraj";38;34957;86;35043;NA;91529;124;2021-04-30;-102040
2021-04-29;"Banskobystrický kraj";55;16839;68;16907;NA;91529;123;2021-04-29;-102164
2021-04-28;"Banskobystrický kraj";66;17959;67;18026;NA;91529;133;2021-04-28;-102287
2021-04-27;"Banskobystrický kraj";70;19152;73;19225;NA;91529;143;2021-04-27;-102420
2021-04-26;"Banskobystrický kraj";34;28517;101;28618;NA;91529;135;2021-04-26;-102563
2021-04-25;"Banskobystrický kraj";14;40601;106;40707;NA;91529;120;2021-04-25;-102698
2021-04-24;"Banskobystrický kraj";40;51944;98;52042;NA;91529;138;2021-04-24;-102818
2021-04-23;"Banskobystrický kraj";78;37922;88;38010;NA;91529;166;2021-04-23;-102956
2021-04-22;"Banskobystrický kraj";51;17415;57;17472;NA;91529;108;2021-04-22;-103122
2021-04-21;"Banskobystrický kraj";76;19218;94;19312;NA;91529;170;2021-04-21;-103230
2021-04-20;"Banskobystrický kraj";116;21234;98;21332;NA;91529;214;2021-04-20;-103400
2021-04-19;"Banskobystrický kraj";48;31408;105;31513;NA;91529;153;2021-04-19;-103614
2021-04-18;"Banskobystrický kraj";16;43375;90;43465;NA;91529;106;2021-04-18;-103767
2021-04-17;"Banskobystrický kraj";42;64939;92;65031;NA;91529;134;2021-04-17;-103873
2021-04-16;"Banskobystrický kraj";72;37307;100;37407;NA;91529;172;2021-04-16;-104007
2021-04-15;"Banskobystrický kraj";67;20127;83;20210;NA;91529;150;2021-04-15;-104179
2021-04-14;"Banskobystrický kraj";69;21260;86;21346;NA;91529;155;2021-04-14;-104329
2021-04-13;"Banskobystrický kraj";130;23076;77;23153;NA;91529;207;2021-04-13;-104484
2021-04-12;"Banskobystrický kraj";60;32272;130;32402;NA;91529;190;2021-04-12;-104691
2021-04-11;"Banskobystrický kraj";0;41367;88;41455;NA;91529;88;2021-04-11;-104881
2021-04-10;"Banskobystrický kraj";56;64728;141;64869;NA;91529;197;2021-04-10;-104969
2021-04-09;"Banskobystrický kraj";106;31570;118;31688;NA;91529;224;2021-04-09;-105166
2021-04-08;"Banskobystrický kraj";132;19000;148;19148;NA;91529;280;2021-04-08;-105390
2021-04-07;"Banskobystrický kraj";226;25121;94;25215;NA;91529;320;2021-04-07;-105670
2021-04-06;"Banskobystrický kraj";93;42496;187;42683;NA;91529;280;2021-04-06;-105990
2021-04-05;"Banskobystrický kraj";15;11797;87;11884;NA;91529;102;2021-04-05;-106270
2021-04-04;"Banskobystrický kraj";24;19683;79;19762;NA;91529;103;2021-04-04;-106372
2021-04-03;"Banskobystrický kraj";5;72553;211;72764;NA;91529;216;2021-04-03;-106475
2021-04-02;"Banskobystrický kraj";71;13455;66;13521;NA;91529;137;2021-04-02;-106691
2021-04-01;"Banskobystrický kraj";171;39407;200;39607;NA;91529;371;2021-04-01;-106828
2021-03-31;"Banskobystrický kraj";147;25543;161;25704;NA;91529;308;2021-03-31;-107199
2021-03-30;"Banskobystrický kraj";167;21442;159;21601;NA;91529;326;2021-03-30;-107507
2021-03-29;"Banskobystrický kraj";119;29492;218;29710;NA;91529;337;2021-03-29;-107833
2021-03-28;"Banskobystrický kraj";25;40610;189;40799;NA;91529;214;2021-03-28;-108170
2021-03-27;"Banskobystrický kraj";85;63414;260;63674;NA;91529;345;2021-03-27;-108384
2021-03-26;"Banskobystrický kraj";122;43671;240;43911;NA;91529;362;2021-03-26;-108729
2021-03-25;"Banskobystrický kraj";120;21598;240;21838;NA;91529;360;2021-03-25;-109091
2021-03-24;"Banskobystrický kraj";200;19337;227;19564;NA;91529;427;2021-03-24;-109451
2021-03-23;"Banskobystrický kraj";241;21541;257;21798;NA;91529;498;2021-03-23;-109878
2021-03-22;"Banskobystrický kraj";65;30480;274;30754;NA;91529;339;2021-03-22;-110376
2021-03-21;"Banskobystrický kraj";31;40039;280;40319;NA;91529;311;2021-03-21;-110715
2021-03-20;"Banskobystrický kraj";119;67926;383;68309;NA;91529;502;2021-03-20;-111026
2021-03-19;"Banskobystrický kraj";240;44038;306;44344;NA;91529;546;2021-03-19;-111528
2021-03-18;"Banskobystrický kraj";160;22469;273;22742;NA;91529;433;2021-03-18;-112074
2021-03-17;"Banskobystrický kraj";262;21573;245;21818;NA;91529;507;2021-03-17;-112507
2021-03-16;"Banskobystrický kraj";340;23349;224;23573;NA;91529;564;2021-03-16;-113014
2021-03-15;"Banskobystrický kraj";95;32306;366;32672;NA;91529;461;2021-03-15;-113578
2021-03-14;"Banskobystrický kraj";39;39212;218;39430;NA;91529;257;2021-03-14;-114039
2021-03-13;"Banskobystrický kraj";209;67463;395;67858;NA;91529;604;2021-03-13;-114296
2021-03-12;"Banskobystrický kraj";206;41444;330;41774;NA;91529;536;2021-03-12;-114900
2021-03-11;"Banskobystrický kraj";228;21338;274;21612;NA;91529;502;2021-03-11;-115436
2021-03-10;"Banskobystrický kraj";260;20408;241;20649;NA;91529;501;2021-03-10;-115938
2021-03-09;"Banskobystrický kraj";352;21790;284;22074;NA;91529;636;2021-03-09;-116439
2021-03-08;"Banskobystrický kraj";191;31471;427;31898;NA;91529;618;2021-03-08;-117075
2021-03-07;"Banskobystrický kraj";60;39191;295;39486;NA;91529;355;2021-03-07;-117693
2021-03-06;"Banskobystrický kraj";164;70897;410;71307;NA;91529;574;2021-03-06;-118048
2021-03-05;"Banskobystrický kraj";221;42336;389;42725;NA;91529;610;2021-03-05;-118622
2021-03-04;"Banskobystrický kraj";226;22009;334;22343;NA;91529;560;2021-03-04;-119232
2021-03-03;"Banskobystrický kraj";317;21949;331;22280;NA;91529;648;2021-03-03;-119792
2021-03-02;"Banskobystrický kraj";291;23160;354;23514;NA;91529;645;2021-03-02;-120440
2021-03-01;"Banskobystrický kraj";151;31773;434;32207;NA;91529;585;2021-03-01;-121085
2021-02-28;"Banskobystrický kraj";45;38665;336;39001;NA;91529;381;2021-02-28;-121670
2021-02-27;"Banskobystrický kraj";289;66667;529;67196;NA;91529;818;2021-02-27;-122051
2021-02-26;"Banskobystrický kraj";326;39674;468;40142;NA;91529;794;2021-02-26;-122869
2021-02-25;"Banskobystrický kraj";375;18081;366;18447;NA;91529;741;2021-02-25;-123663
2021-02-24;"Banskobystrický kraj";332;16735;373;17108;NA;91529;705;2021-02-24;-124404
2021-02-23;"Banskobystrický kraj";462;19932;439;20371;NA;91529;901;2021-02-23;-125109
2021-02-22;"Banskobystrický kraj";67;28643;598;29241;NA;91529;665;2021-02-22;-126010
2021-02-21;"Banskobystrický kraj";68;37619;444;38063;NA;91529;512;2021-02-21;-126675
2021-02-20;"Banskobystrický kraj";280;68851;598;69449;NA;91529;878;2021-02-20;-127187
2021-02-19;"Banskobystrický kraj";420;39888;511;40399;NA;91529;931;2021-02-19;-128065
2021-02-18;"Banskobystrický kraj";241;18618;396;19014;NA;91529;637;2021-02-18;-128996
2021-02-17;"Banskobystrický kraj";415;16740;389;17129;NA;91529;804;2021-02-17;-129633
2021-02-16;"Banskobystrický kraj";338;19731;368;20099;NA;91529;706;2021-02-16;-130437
2021-02-15;"Banskobystrický kraj";118;35835;591;36426;NA;91529;709;2021-02-15;-131143
2021-02-14;"Banskobystrický kraj";60;31894;386;32280;NA;91529;446;2021-02-14;-131852
2021-02-13;"Banskobystrický kraj";202;53889;492;54381;NA;91529;694;2021-02-13;-132298
2021-02-12;"Banskobystrický kraj";312;37270;533;37803;NA;91529;845;2021-02-12;-132992
2021-02-11;"Banskobystrický kraj";305;21196;386;21582;NA;91529;691;2021-02-11;-133837
2021-02-10;"Banskobystrický kraj";333;14790;344;15134;NA;91529;677;2021-02-10;-134528
2021-02-09;"Banskobystrický kraj";329;18504;362;18866;NA;91529;691;2021-02-09;-135205
2021-02-08;"Banskobystrický kraj";103;49716;695;50411;NA;91529;798;2021-02-08;-135896
2021-02-07;"Banskobystrický kraj";70;37659;335;37994;NA;91529;405;2021-02-07;-136694
2021-02-06;"Banskobystrický kraj";178;69388;570;69958;NA;91529;748;2021-02-06;-137099
2021-02-05;"Banskobystrický kraj";282;24577;363;24940;NA;91529;645;2021-02-05;-137847
2021-02-04;"Banskobystrický kraj";240;14367;430;14797;NA;91529;670;2021-02-04;-138492
2021-02-03;"Banskobystrický kraj";350;9459;255;9714;NA;91529;605;2021-02-03;-139162
2021-02-02;"Banskobystrický kraj";277;15741;334;16075;NA;91529;611;2021-02-02;-139767
2021-02-01;"Banskobystrický kraj";75;24346;489;24835;NA;91529;564;2021-02-01;-140378
2021-01-31;"Banskobystrický kraj";34;19983;201;20184;NA;91529;235;2021-01-31;-140942
2021-01-30;"Banskobystrický kraj";163;63896;525;64421;NA;91529;688;2021-01-30;-141177
2021-01-29;"Banskobystrický kraj";196;17368;274;17642;NA;91529;470;2021-01-29;-141865
2021-01-28;"Banskobystrický kraj";218;15613;382;15995;NA;91529;600;2021-01-28;-142335
2021-01-27;"Banskobystrický kraj";191;8132;200;8332;NA;91529;391;2021-01-27;-142935
2021-01-26;"Banskobystrický kraj";238;19795;283;20078;NA;91529;521;2021-01-26;-143326
2021-01-25;"Banskobystrický kraj";82;33666;412;34078;NA;91529;494;2021-01-25;-143847
2021-01-24;"Banskobystrický kraj";38;35587;278;35865;NA;91529;316;2021-01-24;-144341
2021-01-23;"Banskobystrický kraj";142;89058;523;89581;NA;91529;665;2021-01-23;-144657
2021-01-22;"Banskobystrický kraj";175;25887;355;26242;NA;91529;530;2021-01-22;-145322
2021-01-21;"Banskobystrický kraj";194;17063;279;17342;NA;91529;473;2021-01-21;-145852
2021-01-20;"Banskobystrický kraj";231;9142;186;9328;NA;91529;417;2021-01-20;-146325
2021-01-19;"Banskobystrický kraj";213;10708;311;11019;NA;91529;524;2021-01-19;-146742
2021-01-18;"Banskobystrický kraj";94;7402;401;7803;NA;91529;495;2021-01-18;-147266
2021-01-17;"Banskobystrický kraj";110;8154;77;8231;NA;91529;187;2021-01-17;-147761
2021-01-16;"Banskobystrický kraj";58;2274;57;2331;NA;91529;115;2021-01-16;-147948
2021-01-15;"Banskobystrický kraj";164;7673;217;7890;NA;91529;381;2021-01-15;-148063
2021-01-14;"Banskobystrický kraj";220;5760;325;6085;NA;91529;545;2021-01-14;-148444
2021-01-13;"Banskobystrický kraj";235;5974;217;6191;NA;91529;452;2021-01-13;-148989
2021-01-12;"Banskobystrický kraj";194;6600;290;6890;NA;91529;484;2021-01-12;-149441
2021-01-11;"Banskobystrický kraj";76;8231;481;8712;NA;91529;557;2021-01-11;-149925
2021-01-10;"Banskobystrický kraj";110;433;4;437;NA;91529;114;2021-01-10;-150482
2021-01-09;"Banskobystrický kraj";297;2378;81;2459;NA;91529;378;2021-01-09;-150596
2021-01-08;"Banskobystrický kraj";435;9805;443;10248;NA;91529;878;2021-01-08;-150974
2021-01-07;"Banskobystrický kraj";127;6322;366;6688;NA;91529;493;2021-01-07;-151852
2021-01-06;"Banskobystrický kraj";305;3374;185;3559;NA;91529;490;2021-01-06;-152345
2021-01-05;"Banskobystrický kraj";372;7349;533;7882;NA;91529;905;2021-01-05;-152835
2021-01-04;"Banskobystrický kraj";130;7087;700;7787;NA;91529;830;2021-01-04;-153740
2021-01-03;"Banskobystrický kraj";199;320;19;339;NA;91529;218;2021-01-03;-154570
2021-01-02;"Banskobystrický kraj";123;702;85;787;NA;91529;208;2021-01-02;-154788
2021-01-01;"Banskobystrický kraj";220;1958;132;2090;NA;91529;352;2021-01-01;-154996
2020-12-31;"Banskobystrický kraj";499;7679;633;8312;NA;91529;1132;2020-12-31;-155348
2020-12-30;"Banskobystrický kraj";593;7407;541;7948;NA;91529;1134;2020-12-30;-156480
2020-12-29;"Banskobystrický kraj";240;7876;660;8536;NA;91529;900;2020-12-29;-157614
2020-12-28;"Banskobystrický kraj";131;6120;720;6840;NA;91529;851;2020-12-28;-158514
2020-12-27;"Banskobystrický kraj";116;541;25;566;NA;91529;141;2020-12-27;-159365
2020-12-26;"Banskobystrický kraj";61;295;35;330;NA;91529;96;2020-12-26;-159506
2020-12-25;"Banskobystrický kraj";65;888;10;898;NA;91529;75;2020-12-25;-159602
2020-12-24;"Banskobystrický kraj";452;3685;135;3820;NA;91529;587;2020-12-24;-159677
2020-12-23;"Banskobystrický kraj";368;9892;473;10365;NA;91529;841;2020-12-23;-160264
2020-12-22;"Banskobystrický kraj";307;8468;619;9087;NA;91529;926;2020-12-22;-161105
2020-12-21;"Banskobystrický kraj";286;4922;455;5377;NA;91529;741;2020-12-21;-162031
2020-12-20;"Banskobystrický kraj";155;250;14;264;NA;91529;169;2020-12-20;-162772
2020-12-19;"Banskobystrický kraj";170;3084;138;3222;NA;91529;308;2020-12-19;-162941
2020-12-18;"Banskobystrický kraj";432;5959;331;6290;NA;91529;763;2020-12-18;-163249
2020-12-17;"Banskobystrický kraj";468;8753;653;9406;NA;91529;1121;2020-12-17;-164012
2020-12-16;"Banskobystrický kraj";379;10184;567;10751;NA;91529;946;2020-12-16;-165133
2020-12-15;"Banskobystrický kraj";336;5281;425;5706;NA;91529;761;2020-12-15;-166079
2020-12-14;"Banskobystrický kraj";148;4012;259;4271;NA;91529;407;2020-12-14;-166840
2020-12-13;"Banskobystrický kraj";122;142;1;143;NA;91529;123;2020-12-13;-167247
2020-12-12;"Banskobystrický kraj";137;2714;138;2852;NA;91529;275;2020-12-12;-167370
2020-12-11;"Banskobystrický kraj";468;6633;362;6995;NA;91529;830;2020-12-11;-167645
2020-12-10;"Banskobystrický kraj";280;5501;369;5870;NA;91529;649;2020-12-10;-168475
2020-12-09;"Banskobystrický kraj";323;3941;205;4146;NA;91529;528;2020-12-09;-169124
2020-12-08;"Banskobystrický kraj";256;3782;272;4054;NA;91529;528;2020-12-08;-169652
2020-12-07;"Banskobystrický kraj";175;2633;177;2810;NA;91529;352;2020-12-07;-170180
2020-12-06;"Banskobystrický kraj";121;507;11;518;NA;91529;132;2020-12-06;-170532
2020-12-05;"Banskobystrický kraj";109;1099;34;1133;NA;91529;143;2020-12-05;-170664
2020-12-04;"Banskobystrický kraj";339;3828;174;4002;NA;91529;513;2020-12-04;-170807
2020-12-03;"Banskobystrický kraj";240;3193;234;3427;NA;91529;474;2020-12-03;-171320
2020-12-02;"Banskobystrický kraj";217;4442;186;4628;NA;91529;403;2020-12-02;-171794
2020-12-01;"Banskobystrický kraj";215;2702;134;2836;NA;91529;349;2020-12-01;-172197
2020-11-30;"Banskobystrický kraj";74;4314;241;4555;NA;91529;315;2020-11-30;-172546
2020-11-29;"Banskobystrický kraj";19;208;7;215;NA;91529;26;2020-11-29;-172861
2020-11-28;"Banskobystrický kraj";81;1408;55;1463;NA;91529;136;2020-11-28;-172887
2020-11-27;"Banskobystrický kraj";219;2566;123;2689;NA;91529;342;2020-11-27;-173023
2020-11-26;"Banskobystrický kraj";208;2124;93;2217;NA;91529;301;2020-11-26;-173365
2020-11-25;"Banskobystrický kraj";170;1952;86;2038;NA;91529;256;2020-11-25;-173666
2020-11-24;"Banskobystrický kraj";166;2566;69;2635;NA;91529;235;2020-11-24;-173922
2020-11-23;"Banskobystrický kraj";66;10147;193;10340;NA;91529;259;2020-11-23;-174157
2020-11-22;"Banskobystrický kraj";38;104;1;105;NA;91529;39;2020-11-22;-174416
2020-11-21;"Banskobystrický kraj";52;904;14;918;NA;91529;66;2020-11-21;-174455
2020-11-20;"Banskobystrický kraj";127;2005;107;2112;NA;91529;234;2020-11-20;-174521
2020-11-19;"Banskobystrický kraj";170;1218;82;1300;NA;91529;252;2020-11-19;-174755
2020-11-18;"Banskobystrický kraj";153;698;65;763;NA;91529;218;2020-11-18;-175007
2020-11-17;"Banskobystrický kraj";52;578;35;613;NA;91529;87;2020-11-17;-175225
2020-11-16;"Banskobystrický kraj";106;470;25;495;NA;91529;131;2020-11-16;-175312
2020-11-15;"Banskobystrický kraj";52;301;4;305;NA;91529;56;2020-11-15;-175443
2020-11-14;"Banskobystrický kraj";73;305;2;307;NA;91529;75;2020-11-14;-175499
2020-11-13;"Banskobystrický kraj";157;552;11;563;NA;91529;168;2020-11-13;-175574
2020-11-12;"Banskobystrický kraj";218;952;44;996;NA;91529;262;2020-11-12;-175742
2020-11-11;"Banskobystrický kraj";224;437;9;446;NA;91529;233;2020-11-11;-176004
2020-11-10;"Banskobystrický kraj";263;463;18;481;NA;91529;281;2020-11-10;-176237
2020-11-09;"Banskobystrický kraj";80;2678;31;2709;NA;91529;111;2020-11-09;-176518
2020-11-08;"Banskobystrický kraj";82;981;16;997;NA;91529;98;2020-11-08;-176629
2020-11-07;"Banskobystrický kraj";164;8828;94;8922;NA;91529;258;2020-11-07;-176727
2020-11-06;"Banskobystrický kraj";227;2496;16;2512;NA;91529;243;2020-11-06;-176985
2020-11-05;"Banskobystrický kraj";240;290;33;323;NA;91529;273;2020-11-05;-177228
2020-11-04;"Banskobystrický kraj";254;1366;13;1379;NA;91529;267;2020-11-04;-177501
2020-11-03;"Banskobystrický kraj";246;1332;4;1336;NA;91529;250;2020-11-03;-177768
2020-11-02;"Banskobystrický kraj";90;2909;65;2974;NA;91529;155;2020-11-02;-178018
2020-11-01;"Banskobystrický kraj";101;2671;42;2713;NA;91529;143;2020-11-01;-178173
2020-10-31;"Banskobystrický kraj";199;13516;116;13632;NA;91529;315;2020-10-31;-178316
2020-10-30;"Banskobystrický kraj";254;2829;20;2849;NA;91529;274;2020-10-30;-178631
2020-10-29;"Banskobystrický kraj";372;969;42;1011;NA;91529;414;2020-10-29;-178905
2020-10-28;"Banskobystrický kraj";285;302;30;332;NA;91529;315;2020-10-28;-179319
2020-10-27;"Banskobystrický kraj";266;654;40;694;NA;91529;306;2020-10-27;-179634
2020-10-26;"Banskobystrický kraj";38;234;29;263;NA;91529;67;2020-10-26;-179940
2020-10-25;"Banskobystrický kraj";50;140;11;151;NA;91529;61;2020-10-25;-180007
2020-10-24;"Banskobystrický kraj";315;114;12;126;NA;91529;327;2020-10-24;-180068
2020-10-23;"Banskobystrický kraj";231;230;29;259;NA;91529;260;2020-10-23;-180395
2020-10-22;"Banskobystrický kraj";264;253;24;277;NA;91529;288;2020-10-22;-180655
2020-10-21;"Banskobystrický kraj";209;266;3;269;NA;91529;212;2020-10-21;-180943
2020-10-20;"Banskobystrický kraj";210;66;3;69;NA;91529;213;2020-10-20;-181155
2020-10-19;"Banskobystrický kraj";27;73;12;85;NA;91529;39;2020-10-19;-181368
2020-10-18;"Banskobystrický kraj";49;0;0;0;NA;91529;49;2020-10-18;-181407
2020-10-17;"Banskobystrický kraj";91;0;0;0;NA;91529;91;2020-10-17;-181456
2020-10-16;"Banskobystrický kraj";224;37;3;40;NA;91529;227;2020-10-16;-181547
2020-10-15;"Banskobystrický kraj";133;29;1;30;NA;91529;134;2020-10-15;-181774
2020-10-14;"Banskobystrický kraj";139;31;1;32;NA;91529;140;2020-10-14;-181908
2020-10-13;"Banskobystrický kraj";151;169;11;180;NA;91529;162;2020-10-13;-182048
2020-10-12;"Banskobystrický kraj";11;110;4;114;NA;91529;15;2020-10-12;-182210
2020-10-11;"Banskobystrický kraj";14;0;0;0;NA;91529;14;2020-10-11;-182225
2020-10-10;"Banskobystrický kraj";53;0;0;0;NA;91529;53;2020-10-10;-182239
2020-10-09;"Banskobystrický kraj";128;0;0;0;NA;91529;128;2020-10-09;-182292
2020-10-08;"Banskobystrický kraj";99;0;0;0;NA;91529;99;2020-10-08;-182420
2020-10-07;"Banskobystrický kraj";124;0;0;0;NA;91529;124;2020-10-07;-182519
2020-10-06;"Banskobystrický kraj";68;0;0;0;NA;91529;68;2020-10-06;-182643
2020-10-05;"Banskobystrický kraj";49;0;0;0;NA;91529;49;2020-10-05;-182711
2020-10-04;"Banskobystrický kraj";8;0;0;0;NA;91529;8;2020-10-04;-182760
2020-10-03;"Banskobystrický kraj";37;0;0;0;NA;91529;37;2020-10-03;-182768
2020-10-02;"Banskobystrický kraj";74;0;0;0;NA;91529;74;2020-10-02;-182805
2020-10-01;"Banskobystrický kraj";49;16;0;16;NA;91529;49;2020-10-01;-182879
2020-09-30;"Banskobystrický kraj";60;0;0;0;NA;91529;60;2020-09-30;-182928
2020-09-29;"Banskobystrický kraj";24;0;0;0;NA;91529;24;2020-09-29;-182988
2020-09-28;"Banskobystrický kraj";0;0;0;0;NA;91529;0;2020-09-28;-183012
2020-09-27;"Banskobystrický kraj";20;0;0;0;NA;91529;20;2020-09-27;-183012
2020-09-26;"Banskobystrický kraj";24;0;0;0;NA;91529;24;2020-09-26;-183032
2020-09-25;"Banskobystrický kraj";29;0;0;0;NA;91529;29;2020-09-25;-183056
2020-09-24;"Banskobystrický kraj";25;0;0;0;NA;91529;25;2020-09-24;-183085
2020-09-23;"Banskobystrický kraj";17;0;0;0;NA;91529;17;2020-09-23;-183110
2020-09-22;"Banskobystrický kraj";25;0;0;0;NA;91529;25;2020-09-22;-183127
2020-09-21;"Banskobystrický kraj";3;0;0;0;NA;91529;3;2020-09-21;-183152
2020-09-20;"Banskobystrický kraj";0;0;0;0;NA;91529;0;2020-09-20;-183155
2020-09-19;"Banskobystrický kraj";3;0;0;0;NA;91529;3;2020-09-19;-183155
2020-09-18;"Banskobystrický kraj";24;0;0;0;NA;91529;24;2020-09-18;-183158
2020-09-17;"Banskobystrický kraj";14;0;0;0;NA;91529;14;2020-09-17;-183182
2020-09-16;"Banskobystrický kraj";6;0;0;0;NA;91529;6;2020-09-16;-183196
2020-09-15;"Banskobystrický kraj";2;0;0;0;NA;91529;2;2020-09-15;-183202
2020-09-14;"Banskobystrický kraj";13;0;0;0;NA;91529;13;2020-09-14;-183204
2020-09-13;"Banskobystrický kraj";1;0;0;0;NA;91529;1;2020-09-13;-183217
2020-09-12;"Banskobystrický kraj";5;0;0;0;NA;91529;5;2020-09-12;-183218
2020-09-11;"Banskobystrický kraj";19;0;0;0;NA;91529;19;2020-09-11;-183223
2020-09-10;"Banskobystrický kraj";11;0;0;0;NA;91529;11;2020-09-10;-183242
2020-09-09;"Banskobystrický kraj";13;0;0;0;NA;91529;13;2020-09-09;-183253
2020-09-08;"Banskobystrický kraj";5;0;0;0;NA;91529;5;2020-09-08;-183266
2020-09-07;"Banskobystrický kraj";2;0;0;0;NA;91529;2;2020-09-07;-183271
2020-09-06;"Banskobystrický kraj";0;0;0;0;NA;91529;0;2020-09-06;-183273
2020-09-05;"Banskobystrický kraj";0;0;0;0;NA;91529;0;2020-09-05;-183273
2020-09-04;"Banskobystrický kraj";9;0;0;0;NA;91529;9;2020-09-04;-183273
2020-09-03;"Banskobystrický kraj";5;0;0;0;NA;91529;5;2020-09-03;-183282
2020-09-02;"Banskobystrický kraj";6;0;0;0;NA;91529;6;2020-09-02;-183287
2020-09-01;"Banskobystrický kraj";2;0;0;0;NA;91529;2;2020-09-01;-183293
2020-08-31;"Banskobystrický kraj";6;0;0;0;NA;91529;6;2020-08-31;-183295
2020-08-30;"Banskobystrický kraj";0;0;0;0;NA;91529;0;2020-08-30;-183301
2020-08-29;"Banskobystrický kraj";1;0;0;0;NA;91529;1;2020-08-29;-183301
2020-08-28;"Banskobystrický kraj";3;0;0;0;NA;91529;3;2020-08-28;-183302
2020-08-27;"Banskobystrický kraj";1;0;0;0;NA;91529;1;2020-08-27;-183305
2020-08-26;"Banskobystrický kraj";2;0;0;0;NA;91529;2;2020-08-26;-183306
2020-08-25;"Banskobystrický kraj";2;0;0;0;NA;91529;2;2020-08-25;-183308
2020-08-24;"Banskobystrický kraj";0;0;0;0;NA;91529;0;2020-08-24;-183310
2020-08-23;"Banskobystrický kraj";0;0;0;0;NA;91529;0;2020-08-23;-183310
2020-08-22;"Banskobystrický kraj";0;0;0;0;NA;91529;0;2020-08-22;-183310
2020-08-21;"Banskobystrický kraj";4;0;0;0;NA;91529;4;2020-08-21;-183310
2020-08-20;"Banskobystrický kraj";1;0;0;0;NA;91529;1;2020-08-20;-183314
2020-08-19;"Banskobystrický kraj";4;0;0;0;NA;91529;4;2020-08-19;-183315
2020-08-18;"Banskobystrický kraj";0;0;0;0;NA;91529;0;2020-08-18;-183319
2020-08-17;"Banskobystrický kraj";1;0;0;0;NA;91529;1;2020-08-17;-183319
2020-08-16;"Banskobystrický kraj";0;0;0;0;NA;91529;0;2020-08-16;-183320
2020-08-15;"Banskobystrický kraj";0;0;0;0;NA;91529;0;2020-08-15;-183320
2020-08-14;"Banskobystrický kraj";5;0;0;0;NA;91529;5;2020-08-14;-183320
2020-08-13;"Banskobystrický kraj";0;0;0;0;NA;91529;0;2020-08-13;-183325
2020-08-12;"Banskobystrický kraj";0;0;0;0;NA;91529;0;2020-08-12;-183325
2020-08-11;"Banskobystrický kraj";2;0;0;0;NA;91529;2;2020-08-11;-183325
2020-08-10;"Banskobystrický kraj";3;0;0;0;NA;91529;3;2020-08-10;-183327
2020-08-09;"Banskobystrický kraj";0;0;0;0;NA;91529;0;2020-08-09;-183330
2020-08-08;"Banskobystrický kraj";2;0;0;0;NA;91529;2;2020-08-08;-183330
2020-08-07;"Banskobystrický kraj";1;0;0;0;NA;91529;1;2020-08-07;-183332
2020-08-06;"Banskobystrický kraj";1;0;0;0;NA;91529;1;2020-08-06;-183333
2020-08-05;"Banskobystrický kraj";0;0;0;0;NA;91529;0;2020-08-05;-183334
2020-08-04;"Banskobystrický kraj";3;0;0;0;NA;91529;3;2020-08-04;-183334
2020-08-03;"Banskobystrický kraj";0;0;0;0;NA;91529;0;2020-08-03;-183337
2020-08-02;"Banskobystrický kraj";0;0;0;0;NA;91529;0;2020-08-02;-183337
2020-08-01;"Banskobystrický kraj";1;0;0;0;NA;91529;1;2020-08-01;-183337
2020-07-31;"Banskobystrický kraj";2;0;0;0;NA;91529;2;2020-07-31;-183338
2020-07-30;"Banskobystrický kraj";1;0;0;0;NA;91529;1;2020-07-30;-183340
2020-07-29;"Banskobystrický kraj";0;0;0;0;NA;91529;0;2020-07-29;-183341
2020-07-28;"Banskobystrický kraj";2;0;0;0;NA;91529;2;2020-07-28;-183341
2020-07-27;"Banskobystrický kraj";3;0;0;0;NA;91529;3;2020-07-27;-183343
2020-07-26;"Banskobystrický kraj";0;0;0;0;NA;91529;0;2020-07-26;-183346
2020-07-25;"Banskobystrický kraj";0;0;0;0;NA;91529;0;2020-07-25;-183346
2020-07-24;"Banskobystrický kraj";9;0;0;0;NA;91529;9;2020-07-24;-183346
2020-07-23;"Banskobystrický kraj";0;0;0;0;NA;91529;0;2020-07-23;-183355
2020-07-22;"Banskobystrický kraj";3;0;0;0;NA;91529;3;2020-07-22;-183355
2020-07-21;"Banskobystrický kraj";3;0;0;0;NA;91529;3;2020-07-21;-183358
2020-07-20;"Banskobystrický kraj";1;0;0;0;NA;91529;1;2020-07-20;-183361
2020-07-19;"Banskobystrický kraj";1;0;0;0;NA;91529;1;2020-07-19;-183362
2020-07-18;"Banskobystrický kraj";0;0;0;0;NA;91529;0;2020-07-18;-183363
2020-07-17;"Banskobystrický kraj";2;0;0;0;NA;91529;2;2020-07-17;-183363
2020-07-16;"Banskobystrický kraj";1;0;0;0;NA;91529;1;2020-07-16;-183365
2020-07-15;"Banskobystrický kraj";4;0;0;0;NA;91529;4;2020-07-15;-183366
2020-07-14;"Banskobystrický kraj";2;0;0;0;NA;91529;2;2020-07-14;-183370
2020-07-13;"Banskobystrický kraj";1;0;0;0;NA;91529;1;2020-07-13;-183372
2020-07-12;"Banskobystrický kraj";0;0;0;0;NA;91529;0;2020-07-12;-183373
2020-07-11;"Banskobystrický kraj";0;0;0;0;NA;91529;0;2020-07-11;-183373
2020-07-10;"Banskobystrický kraj";3;0;0;0;NA;91529;3;2020-07-10;-183373
2020-07-09;"Banskobystrický kraj";9;0;0;0;NA;91529;9;2020-07-09;-183376
2020-07-08;"Banskobystrický kraj";0;0;0;0;NA;91529;0;2020-07-08;-183385
2020-07-07;"Banskobystrický kraj";4;0;0;0;NA;91529;4;2020-07-07;-183385
2020-07-06;"Banskobystrický kraj";0;0;0;0;NA;91529;0;2020-07-06;-183389
2020-07-05;"Banskobystrický kraj";0;0;0;0;NA;91529;0;2020-07-05;-183389
2020-07-04;"Banskobystrický kraj";1;0;0;0;NA;91529;1;2020-07-04;-183389
2020-07-03;"Banskobystrický kraj";4;0;0;0;NA;91529;4;2020-07-03;-183390
2020-07-02;"Banskobystrický kraj";0;0;0;0;NA;91529;0;2020-07-02;-183394
2020-07-01;"Banskobystrický kraj";1;0;0;0;NA;91529;1;2020-07-01;-183394
2020-06-30;"Banskobystrický kraj";0;12;0;12;NA;91529;0;2020-06-30;-183395
2020-06-29;"Banskobystrický kraj";0;0;0;0;NA;91529;0;2020-06-29;-183395
2020-06-28;"Banskobystrický kraj";0;0;0;0;NA;91529;0;2020-06-28;-183395
2020-06-27;"Banskobystrický kraj";0;0;0;0;NA;91529;0;2020-06-27;-183395
2020-06-26;"Banskobystrický kraj";0;0;0;0;NA;91529;0;2020-06-26;-183395
2020-06-25;"Banskobystrický kraj";1;0;0;0;NA;91529;1;2020-06-25;-183395
2020-06-24;"Banskobystrický kraj";0;0;0;0;NA;91529;0;2020-06-24;-183396
2020-06-23;"Banskobystrický kraj";6;0;0;0;NA;91529;6;2020-06-23;-183396
2020-06-22;"Banskobystrický kraj";0;0;0;0;NA;91529;0;2020-06-22;-183402
2020-06-21;"Banskobystrický kraj";0;0;0;0;NA;91529;0;2020-06-21;-183402
2020-06-20;"Banskobystrický kraj";0;0;0;0;NA;91529;0;2020-06-20;-183402
2020-06-19;"Banskobystrický kraj";2;0;0;0;NA;91529;2;2020-06-19;-183402
2020-06-18;"Banskobystrický kraj";10;0;0;0;NA;91529;10;2020-06-18;-183404
2020-06-17;"Banskobystrický kraj";1;0;0;0;NA;91529;1;2020-06-17;-183414
2020-06-16;"Banskobystrický kraj";0;0;0;0;NA;91529;0;2020-06-16;-183415
2020-06-14;"Banskobystrický kraj";2;0;0;0;NA;91529;2;2020-06-14;-183415
2020-06-13;"Banskobystrický kraj";2;0;0;0;NA;91529;2;2020-06-13;-183417
2020-06-12;"Banskobystrický kraj";0;0;0;0;NA;91529;0;2020-06-12;-183419
2020-06-11;"Banskobystrický kraj";1;0;0;0;NA;91529;1;2020-06-11;-183419
2020-06-10;"Banskobystrický kraj";0;0;0;0;NA;91529;0;2020-06-10;-183420
2020-06-09;"Banskobystrický kraj";0;0;0;0;NA;91529;0;2020-06-09;-183420
2020-06-08;"Banskobystrický kraj";0;0;0;0;NA;91529;0;2020-06-08;-183420
2020-06-07;"Banskobystrický kraj";0;0;0;0;NA;91529;0;2020-06-07;-183420
2020-06-05;"Banskobystrický kraj";2;0;0;0;NA;91529;2;2020-06-05;-183420
2020-06-03;"Banskobystrický kraj";0;0;0;0;NA;91529;0;2020-06-03;-183422
2020-06-02;"Banskobystrický kraj";0;0;0;0;NA;91529;0;2020-06-02;-183422
2020-05-31;"Banskobystrický kraj";0;0;0;0;NA;91529;0;2020-05-31;-183422
2020-05-29;"Banskobystrický kraj";0;0;0;0;NA;91529;0;2020-05-29;-183422
2020-05-27;"Banskobystrický kraj";1;0;0;0;NA;91529;1;2020-05-27;-183422
2020-05-26;"Banskobystrický kraj";0;0;0;0;NA;91529;0;2020-05-26;-183423
2020-05-25;"Banskobystrický kraj";0;0;0;0;NA;91529;0;2020-05-25;-183423
2020-05-24;"Banskobystrický kraj";0;0;0;0;NA;91529;0;2020-05-24;-183423
2020-05-23;"Banskobystrický kraj";1;0;0;0;NA;91529;1;2020-05-23;-183423
2020-05-22;"Banskobystrický kraj";0;0;0;0;NA;91529;0;2020-05-22;-183424
2020-05-21;"Banskobystrický kraj";0;0;0;0;NA;91529;0;2020-05-21;-183424
2020-05-20;"Banskobystrický kraj";1;0;0;0;NA;91529;1;2020-05-20;-183424
2020-05-19;"Banskobystrický kraj";0;0;0;0;NA;91529;0;2020-05-19;-183425
2020-05-17;"Banskobystrický kraj";0;0;0;0;NA;91529;0;2020-05-17;-183425
2020-05-16;"Banskobystrický kraj";0;0;0;0;NA;91529;0;2020-05-16;-183425
2020-05-15;"Banskobystrický kraj";0;0;0;0;NA;91529;0;2020-05-15;-183425
2020-05-14;"Banskobystrický kraj";0;0;0;0;NA;91529;0;2020-05-14;-183425
2020-05-13;"Banskobystrický kraj";0;0;0;0;NA;91529;0;2020-05-13;-183425
2020-05-12;"Banskobystrický kraj";1;0;0;0;NA;91529;1;2020-05-12;-183425
2020-05-11;"Banskobystrický kraj";0;0;0;0;NA;91529;0;2020-05-11;-183426
2020-05-09;"Banskobystrický kraj";0;0;0;0;NA;91529;0;2020-05-09;-183426
2020-05-07;"Banskobystrický kraj";2;0;0;0;NA;91529;2;2020-05-07;-183426
2020-05-06;"Banskobystrický kraj";1;0;0;0;NA;91529;1;2020-05-06;-183428
2020-05-05;"Banskobystrický kraj";2;0;0;0;NA;91529;2;2020-05-05;-183429
2020-05-04;"Banskobystrický kraj";0;0;0;0;NA;91529;0;2020-05-04;-183431
2020-05-03;"Banskobystrický kraj";0;0;0;0;NA;91529;0;2020-05-03;-183431
2020-05-02;"Banskobystrický kraj";0;0;0;0;NA;91529;0;2020-05-02;-183431
2020-05-01;"Banskobystrický kraj";0;0;0;0;NA;91529;0;2020-05-01;-183431
2020-04-30;"Banskobystrický kraj";1;0;0;0;NA;91529;1;2020-04-30;-183431
2020-04-29;"Banskobystrický kraj";1;0;0;0;NA;91529;1;2020-04-29;-183432
2020-04-28;"Banskobystrický kraj";0;0;0;0;NA;91529;0;2020-04-28;-183433
2020-04-27;"Banskobystrický kraj";0;0;0;0;NA;91529;0;2020-04-27;-183433
2020-04-26;"Banskobystrický kraj";0;0;0;0;NA;91529;0;2020-04-26;-183433
2020-04-25;"Banskobystrický kraj";2;0;0;0;NA;91529;2;2020-04-25;-183433
2020-04-24;"Banskobystrický kraj";3;0;0;0;NA;91529;3;2020-04-24;-183435
2020-04-23;"Banskobystrický kraj";2;0;0;0;NA;91529;2;2020-04-23;-183438
2020-04-22;"Banskobystrický kraj";2;0;0;0;NA;91529;2;2020-04-22;-183440
2020-04-21;"Banskobystrický kraj";2;0;0;0;NA;91529;2;2020-04-21;-183442
2020-04-20;"Banskobystrický kraj";0;0;0;0;NA;91529;0;2020-04-20;-183444
2020-04-19;"Banskobystrický kraj";0;0;0;0;NA;91529;0;2020-04-19;-183444
2020-04-18;"Banskobystrický kraj";8;0;0;0;NA;91529;8;2020-04-18;-183444
2020-04-17;"Banskobystrický kraj";2;0;0;0;NA;91529;2;2020-04-17;-183452
2020-04-16;"Banskobystrický kraj";0;0;0;0;NA;91529;0;2020-04-16;-183454
2020-04-15;"Banskobystrický kraj";10;0;0;0;NA;91529;10;2020-04-15;-183454
2020-04-14;"Banskobystrický kraj";0;0;0;0;NA;91529;0;2020-04-14;-183464
2020-04-13;"Banskobystrický kraj";2;0;0;0;NA;91529;2;2020-04-13;-183464
2020-04-12;"Banskobystrický kraj";4;0;0;0;NA;91529;4;2020-04-12;-183466
2020-04-11;"Banskobystrický kraj";1;0;0;0;NA;91529;1;2020-04-11;-183470
2020-04-10;"Banskobystrický kraj";0;0;0;0;NA;91529;0;2020-04-10;-183471
2020-04-09;"Banskobystrický kraj";2;0;0;0;NA;91529;2;2020-04-09;-183471
2020-04-08;"Banskobystrický kraj";0;0;0;0;NA;91529;0;2020-04-08;-183473
2020-04-07;"Banskobystrický kraj";4;0;0;0;NA;91529;4;2020-04-07;-183473
2020-04-06;"Banskobystrický kraj";10;0;0;0;NA;91529;10;2020-04-06;-183477
2020-04-05;"Banskobystrický kraj";9;0;0;0;NA;91529;9;2020-04-05;-183487
2020-04-04;"Banskobystrický kraj";0;0;0;0;NA;91529;0;2020-04-04;-183496
2020-04-03;"Banskobystrický kraj";2;0;0;0;NA;91529;2;2020-04-03;-183496
2020-04-02;"Banskobystrický kraj";2;0;0;0;NA;91529;2;2020-04-02;-183498
2020-04-01;"Banskobystrický kraj";5;0;0;0;NA;91529;5;2020-04-01;-183500
2020-03-31;"Banskobystrický kraj";3;0;0;0;NA;91529;3;2020-03-31;-183505
2020-03-30;"Banskobystrický kraj";1;0;0;0;NA;91529;1;2020-03-30;-183508
2020-03-29;"Banskobystrický kraj";2;0;0;0;NA;91529;2;2020-03-29;-183509
2020-03-28;"Banskobystrický kraj";1;0;0;0;NA;91529;1;2020-03-28;-183511
2020-03-27;"Banskobystrický kraj";1;0;0;0;NA;91529;1;2020-03-27;-183512
2020-03-26;"Banskobystrický kraj";1;0;0;0;NA;91529;1;2020-03-26;-183513
2020-03-25;"Banskobystrický kraj";0;0;0;0;NA;91529;0;2020-03-25;-183514
2020-03-24;"Banskobystrický kraj";1;0;0;0;NA;91529;1;2020-03-24;-183514
2020-03-23;"Banskobystrický kraj";1;0;0;0;NA;91529;1;2020-03-23;-183515
2020-03-22;"Banskobystrický kraj";0;0;0;0;NA;91529;0;2020-03-22;-183516
2020-03-21;"Banskobystrický kraj";3;0;0;0;NA;91529;3;2020-03-21;-183516
2020-03-20;"Banskobystrický kraj";0;0;0;0;NA;91529;0;2020-03-20;-183519
2020-03-19;"Banskobystrický kraj";2;0;0;0;NA;91529;2;2020-03-19;-183519
2020-03-18;"Banskobystrický kraj";1;0;0;0;NA;91529;1;2020-03-18;-183521
2020-03-17;"Banskobystrický kraj";1;0;0;0;NA;91529;1;2020-03-17;-183522
2020-03-16;"Banskobystrický kraj";0;0;0;0;NA;91529;0;2020-03-16;-183523
2020-03-15;"Banskobystrický kraj";1;0;0;0;NA;91529;1;2020-03-15;-183523
2020-03-14;"Banskobystrický kraj";0;0;0;0;NA;91529;0;2020-03-14;-183524
2020-03-13;"Banskobystrický kraj";1;0;0;0;NA;91529;1;2020-03-13;-183524
2020-03-12;"Banskobystrický kraj";0;0;0;0;NA;91529;0;2020-03-12;-183525
2020-03-11;"Banskobystrický kraj";0;0;0;0;NA;91529;0;2020-03-11;-183525
2020-03-09;"Banskobystrický kraj";0;0;0;0;NA;91529;0;2020-03-09;-183525
2020-03-08;"Banskobystrický kraj";0;0;0;0;NA;91529;0;2020-03-08;-183525
2020-03-07;"Banskobystrický kraj";0;0;0;0;NA;91529;0;2020-03-07;-183525
2020-03-06;"Banskobystrický kraj";0;0;0;0;NA;91529;0;2020-03-06;-183525
2022-06-26;"Bratislavský kraj";63;138;13;151;NA;93731;76;2022-06-26;93731
2022-06-25;"Bratislavský kraj";90;145;8;153;NA;93731;98;2022-06-25;93655
2022-06-24;"Bratislavský kraj";130;254;24;278;NA;93731;154;2022-06-24;93557
2022-06-23;"Bratislavský kraj";120;420;16;436;NA;93731;136;2022-06-23;93403
2022-06-22;"Bratislavský kraj";114;366;10;376;NA;93731;124;2022-06-22;93267
2022-06-21;"Bratislavský kraj";117;292;13;305;NA;93731;130;2022-06-21;93143
2022-06-20;"Bratislavský kraj";114;400;17;417;NA;93731;131;2022-06-20;93013
2022-06-19;"Bratislavský kraj";46;222;15;237;NA;93731;61;2022-06-19;92882
2022-06-18;"Bratislavský kraj";68;208;14;222;NA;93731;82;2022-06-18;92821
2022-06-17;"Bratislavský kraj";71;327;13;340;NA;93731;84;2022-06-17;92739
2022-06-16;"Bratislavský kraj";69;327;15;342;NA;93731;84;2022-06-16;92655
2022-06-15;"Bratislavský kraj";37;288;12;300;NA;93731;49;2022-06-15;92571
2022-06-14;"Bratislavský kraj";66;301;14;315;NA;93731;80;2022-06-14;92522
2022-06-13;"Bratislavský kraj";56;411;18;429;NA;93731;74;2022-06-13;92442
2022-06-12;"Bratislavský kraj";19;294;25;319;NA;93731;44;2022-06-12;92368
2022-06-11;"Bratislavský kraj";29;315;9;324;NA;93731;38;2022-06-11;92324
2022-06-10;"Bratislavský kraj";41;265;3;268;NA;93731;44;2022-06-10;92286
2022-06-09;"Bratislavský kraj";66;496;10;506;NA;93731;76;2022-06-09;92242
2022-06-08;"Bratislavský kraj";46;623;18;641;NA;93731;64;2022-06-08;92166
2022-06-07;"Bratislavský kraj";39;643;9;652;NA;93731;48;2022-06-07;92102
2022-06-06;"Bratislavský kraj";43;793;7;800;NA;93731;50;2022-06-06;92054
2022-06-05;"Bratislavský kraj";16;223;8;231;NA;93731;24;2022-06-05;92004
2022-06-04;"Bratislavský kraj";22;227;9;236;NA;93731;31;2022-06-04;91980
2022-06-03;"Bratislavský kraj";32;611;15;626;NA;93731;47;2022-06-03;91949
2022-06-02;"Bratislavský kraj";34;784;18;802;NA;93731;52;2022-06-02;91902
2022-06-01;"Bratislavský kraj";39;694;15;709;NA;93731;54;2022-06-01;91850
2022-05-31;"Bratislavský kraj";34;735;16;751;NA;93731;50;2022-05-31;91796
2022-05-30;"Bratislavský kraj";36;792;11;803;NA;93731;47;2022-05-30;91746
2022-05-29;"Bratislavský kraj";20;251;5;256;NA;93731;25;2022-05-29;91699
2022-05-28;"Bratislavský kraj";30;242;6;248;NA;93731;36;2022-05-28;91674
2022-05-27;"Bratislavský kraj";48;672;14;686;NA;93731;62;2022-05-27;91638
2022-05-26;"Bratislavský kraj";46;851;12;863;NA;93731;58;2022-05-26;91576
2022-05-25;"Bratislavský kraj";36;700;7;707;NA;93731;43;2022-05-25;91518
2022-05-24;"Bratislavský kraj";46;874;11;885;NA;93731;57;2022-05-24;91475
2022-05-23;"Bratislavský kraj";66;819;11;830;NA;93731;77;2022-05-23;91418
2022-05-22;"Bratislavský kraj";25;288;4;292;NA;93731;29;2022-05-22;91341
2022-05-21;"Bratislavský kraj";35;258;6;264;NA;93731;41;2022-05-21;91312
2022-05-20;"Bratislavský kraj";39;907;2;909;NA;93731;41;2022-05-20;91271
2022-05-19;"Bratislavský kraj";50;928;11;939;NA;93731;61;2022-05-19;91230
2022-05-18;"Bratislavský kraj";66;763;10;773;NA;93731;76;2022-05-18;91169
2022-05-17;"Bratislavský kraj";49;903;15;918;NA;93731;64;2022-05-17;91093
2022-05-16;"Bratislavský kraj";56;989;16;1005;NA;93731;72;2022-05-16;91029
2022-05-15;"Bratislavský kraj";16;316;5;321;NA;93731;21;2022-05-15;90957
2022-05-14;"Bratislavský kraj";33;410;11;421;NA;93731;44;2022-05-14;90936
2022-05-13;"Bratislavský kraj";63;962;8;970;NA;93731;71;2022-05-13;90892
2022-05-12;"Bratislavský kraj";59;936;13;949;NA;93731;72;2022-05-12;90821
2022-05-11;"Bratislavský kraj";89;988;17;1005;NA;93731;106;2022-05-11;90749
2022-05-10;"Bratislavský kraj";82;1004;17;1021;NA;93731;99;2022-05-10;90643
2022-05-09;"Bratislavský kraj";89;1108;36;1144;NA;93731;125;2022-05-09;90544
2022-05-08;"Bratislavský kraj";31;360;7;367;NA;93731;38;2022-05-08;90419
2022-05-07;"Bratislavský kraj";79;349;8;357;NA;93731;87;2022-05-07;90381
2022-05-06;"Bratislavský kraj";89;1043;14;1057;NA;93731;103;2022-05-06;90294
2022-05-05;"Bratislavský kraj";137;1136;11;1147;NA;93731;148;2022-05-05;90191
2022-05-04;"Bratislavský kraj";153;1159;28;1187;NA;93731;181;2022-05-04;90043
2022-05-03;"Bratislavský kraj";137;1206;29;1235;NA;93731;166;2022-05-03;89862
2022-05-02;"Bratislavský kraj";174;2123;51;2174;NA;93731;225;2022-05-02;89696
2022-05-01;"Bratislavský kraj";54;655;15;670;NA;93731;69;2022-05-01;89471
2022-04-30;"Bratislavský kraj";178;705;9;714;NA;93731;187;2022-04-30;89402
2022-04-29;"Bratislavský kraj";192;1911;34;1945;NA;93731;226;2022-04-29;89215
2022-04-28;"Bratislavský kraj";206;1731;21;1752;NA;93731;227;2022-04-28;88989
2022-04-27;"Bratislavský kraj";188;1875;24;1899;NA;93731;212;2022-04-27;88762
2022-04-26;"Bratislavský kraj";292;1786;37;1823;NA;93731;329;2022-04-26;88550
2022-04-25;"Bratislavský kraj";199;2342;46;2388;NA;93731;245;2022-04-25;88221
2022-04-24;"Bratislavský kraj";126;815;31;846;NA;93731;157;2022-04-24;87976
2022-04-23;"Bratislavský kraj";216;760;18;778;NA;93731;234;2022-04-23;87819
2022-04-22;"Bratislavský kraj";343;1780;43;1823;NA;93731;386;2022-04-22;87585
2022-04-21;"Bratislavský kraj";359;1933;59;1992;NA;93731;418;2022-04-21;87199
2022-04-20;"Bratislavský kraj";543;2153;48;2201;NA;93731;591;2022-04-20;86781
2022-04-19;"Bratislavský kraj";253;2891;99;2990;NA;93731;352;2022-04-19;86190
2022-04-18;"Bratislavský kraj";174;710;26;736;NA;93731;200;2022-04-18;85838
2022-04-17;"Bratislavský kraj";315;655;27;682;NA;93731;342;2022-04-17;85638
2022-04-16;"Bratislavský kraj";170;761;33;794;NA;93731;203;2022-04-16;85296
2022-04-15;"Bratislavský kraj";281;835;25;860;NA;93731;306;2022-04-15;85093
2022-04-14;"Bratislavský kraj";538;1896;63;1959;NA;93731;601;2022-04-14;84787
2022-04-13;"Bratislavský kraj";555;1917;47;1964;NA;93731;602;2022-04-13;84186
2022-04-12;"Bratislavský kraj";612;2239;68;2307;NA;93731;680;2022-04-12;83584
2022-04-11;"Bratislavský kraj";514;2967;105;3072;NA;93731;619;2022-04-11;82904
2022-04-10;"Bratislavský kraj";293;963;63;1026;NA;93731;356;2022-04-10;82285
2022-04-09;"Bratislavský kraj";610;898;43;941;NA;93731;653;2022-04-09;81929
2022-04-08;"Bratislavský kraj";668;1746;82;1828;NA;93731;750;2022-04-08;81276
2022-04-07;"Bratislavský kraj";833;2348;96;2444;NA;93731;929;2022-04-07;80526
2022-04-06;"Bratislavský kraj";865;2042;100;2142;NA;93731;965;2022-04-06;79597
2022-04-05;"Bratislavský kraj";914;2358;127;2485;NA;93731;1041;2022-04-05;78632
2022-04-04;"Bratislavský kraj";827;3232;167;3399;NA;93731;994;2022-04-04;77591
2022-04-03;"Bratislavský kraj";589;1031;70;1101;NA;93731;659;2022-04-03;76597
2022-04-02;"Bratislavský kraj";863;1128;75;1203;NA;93731;938;2022-04-02;75938
2022-04-01;"Bratislavský kraj";1381;2274;128;2402;NA;93731;1509;2022-04-01;75000
2022-03-31;"Bratislavský kraj";1305;2861;154;3015;NA;93731;1459;2022-03-31;73491
2022-03-30;"Bratislavský kraj";1516;2133;161;2294;NA;93731;1677;2022-03-30;72032
2022-03-29;"Bratislavský kraj";1327;2570;216;2786;NA;93731;1543;2022-03-29;70355
2022-03-28;"Bratislavský kraj";1275;4214;267;4481;NA;93731;1542;2022-03-28;68812
2022-03-27;"Bratislavský kraj";962;1236;151;1387;NA;93731;1113;2022-03-27;67270
2022-03-26;"Bratislavský kraj";1391;1170;105;1275;NA;93731;1496;2022-03-26;66157
2022-03-25;"Bratislavský kraj";1793;2513;170;2683;NA;93731;1963;2022-03-25;64661
2022-03-24;"Bratislavský kraj";1708;2866;197;3063;NA;93731;1905;2022-03-24;62698
2022-03-23;"Bratislavský kraj";2093;2832;200;3032;NA;93731;2293;2022-03-23;60793
2022-03-22;"Bratislavský kraj";1857;2889;236;3125;NA;93731;2093;2022-03-22;58500
2022-03-21;"Bratislavský kraj";1469;4361;383;4744;NA;93731;1852;2022-03-21;56407
2022-03-20;"Bratislavský kraj";935;1359;181;1540;NA;93731;1116;2022-03-20;54555
2022-03-19;"Bratislavský kraj";1672;1510;142;1652;NA;93731;1814;2022-03-19;53439
2022-03-18;"Bratislavský kraj";1977;2942;209;3151;NA;93731;2186;2022-03-18;51625
2022-03-17;"Bratislavský kraj";2024;3501;253;3754;NA;93731;2277;2022-03-17;49439
2022-03-16;"Bratislavský kraj";1895;2773;265;3038;NA;93731;2160;2022-03-16;47162
2022-03-15;"Bratislavský kraj";1982;3813;343;4156;NA;93731;2325;2022-03-15;45002
2022-03-14;"Bratislavský kraj";1557;4138;348;4486;NA;93731;1905;2022-03-14;42677
2022-03-13;"Bratislavský kraj";738;1324;166;1490;NA;93731;904;2022-03-13;40772
2022-03-12;"Bratislavský kraj";1632;1264;110;1374;NA;93731;1742;2022-03-12;39868
2022-03-11;"Bratislavský kraj";1184;3161;318;3479;NA;93731;1502;2022-03-11;38126
2022-03-10;"Bratislavský kraj";1706;3603;355;3958;NA;93731;2061;2022-03-10;36624
2022-03-09;"Bratislavský kraj";1723;2818;276;3094;NA;93731;1999;2022-03-09;34563
2022-03-08;"Bratislavský kraj";1925;3830;342;4172;NA;93731;2267;2022-03-08;32564
2022-03-07;"Bratislavský kraj";1451;4303;486;4789;NA;93731;1937;2022-03-07;30297
2022-03-06;"Bratislavský kraj";850;1557;217;1774;NA;93731;1067;2022-03-06;28360
2022-03-05;"Bratislavský kraj";1203;1345;183;1528;NA;93731;1386;2022-03-05;27293
2022-03-04;"Bratislavský kraj";1443;3024;309;3333;NA;93731;1752;2022-03-04;25907
2022-03-03;"Bratislavský kraj";1599;3287;330;3617;NA;93731;1929;2022-03-03;24155
2022-03-02;"Bratislavský kraj";1677;2555;319;2874;NA;93731;1996;2022-03-02;22226
2022-03-01;"Bratislavský kraj";1560;3676;344;4020;NA;93731;1904;2022-03-01;20230
2022-02-28;"Bratislavský kraj";1593;4052;472;4524;NA;93731;2065;2022-02-28;18326
2022-02-27;"Bratislavský kraj";1156;1746;227;1973;NA;93731;1383;2022-02-27;16261
2022-02-26;"Bratislavský kraj";1228;1749;209;1958;NA;93731;1437;2022-02-26;14878
2022-02-25;"Bratislavský kraj";1692;3604;323;3927;NA;93731;2015;2022-02-25;13441
2022-02-24;"Bratislavský kraj";1760;3992;324;4316;NA;93731;2084;2022-02-24;11426
2022-02-23;"Bratislavský kraj";2105;3450;393;3843;NA;93731;2498;2022-02-23;9342
2022-02-22;"Bratislavský kraj";2951;4213;384;4597;NA;93731;3335;2022-02-22;6844
2022-02-21;"Bratislavský kraj";781;5116;517;5633;NA;93731;1298;2022-02-21;3509
2022-02-20;"Bratislavský kraj";1314;2005;294;2299;NA;93731;1608;2022-02-20;2211
2022-02-19;"Bratislavský kraj";1510;1929;235;2164;NA;93731;1745;2022-02-19;603
2022-02-18;"Bratislavský kraj";2315;3835;378;4213;NA;93731;2693;2022-02-18;-1142
2022-02-17;"Bratislavský kraj";2279;4412;416;4828;NA;93731;2695;2022-02-17;-3835
2022-02-16;"Bratislavský kraj";2137;3749;419;4168;NA;93731;2556;2022-02-16;-6530
2022-02-15;"Bratislavský kraj";2276;4894;475;5369;NA;93731;2751;2022-02-15;-9086
2022-02-14;"Bratislavský kraj";2700;6170;601;6771;NA;93731;3301;2022-02-14;-11837
2022-02-13;"Bratislavský kraj";1343;2248;395;2643;NA;93731;1738;2022-02-13;-15138
2022-02-12;"Bratislavský kraj";1872;2273;336;2609;NA;93731;2208;2022-02-12;-16876
2022-02-11;"Bratislavský kraj";2431;5054;419;5473;NA;93731;2850;2022-02-11;-19084
2022-02-10;"Bratislavský kraj";2595;4563;427;4990;NA;93731;3022;2022-02-10;-21934
2022-02-09;"Bratislavský kraj";2414;4706;477;5183;NA;93731;2891;2022-02-09;-24956
2022-02-08;"Bratislavský kraj";2878;5134;512;5646;NA;93731;3390;2022-02-08;-27847
2022-02-07;"Bratislavský kraj";2636;6970;668;7638;NA;93731;3304;2022-02-07;-31237
2022-02-06;"Bratislavský kraj";1680;3005;382;3387;NA;93731;2062;2022-02-06;-34541
2022-02-05;"Bratislavský kraj";2156;2456;315;2771;NA;93731;2471;2022-02-05;-36603
2022-02-04;"Bratislavský kraj";2586;4679;408;5087;NA;93731;2994;2022-02-04;-39074
2022-02-03;"Bratislavský kraj";2540;6005;435;6440;NA;93731;2975;2022-02-03;-42068
2022-02-02;"Bratislavský kraj";2655;5035;465;5500;NA;93731;3120;2022-02-02;-45043
2022-02-01;"Bratislavský kraj";2758;6001;469;6470;NA;93731;3227;2022-02-01;-48163
2022-01-31;"Bratislavský kraj";2172;8357;712;9069;NA;93731;2884;2022-01-31;-51390
2022-01-30;"Bratislavský kraj";1418;3314;362;3676;NA;93731;1780;2022-01-30;-54274
2022-01-29;"Bratislavský kraj";1762;3138;326;3464;NA;93731;2088;2022-01-29;-56054
2022-01-28;"Bratislavský kraj";2237;5047;389;5436;NA;93731;2626;2022-01-28;-58142
2022-01-27;"Bratislavský kraj";2014;5975;334;6309;NA;93731;2348;2022-01-27;-60768
2022-01-26;"Bratislavský kraj";1792;4895;367;5262;NA;93731;2159;2022-01-26;-63116
2022-01-25;"Bratislavský kraj";1933;5551;385;5936;NA;93731;2318;2022-01-25;-65275
2022-01-24;"Bratislavský kraj";1173;7911;315;8226;NA;93731;1488;2022-01-24;-67593
2022-01-23;"Bratislavský kraj";862;3289;151;3440;NA;93731;1013;2022-01-23;-69081
2022-01-22;"Bratislavský kraj";1130;2802;125;2927;NA;93731;1255;2022-01-22;-70094
2022-01-21;"Bratislavský kraj";1057;4656;166;4822;NA;93731;1223;2022-01-21;-71349
2022-01-20;"Bratislavský kraj";940;4893;146;5039;NA;93731;1086;2022-01-20;-72572
2022-01-19;"Bratislavský kraj";857;4618;169;4787;NA;93731;1026;2022-01-19;-73658
2022-01-18;"Bratislavský kraj";794;5002;163;5165;NA;93731;957;2022-01-18;-74684
2022-01-17;"Bratislavský kraj";534;7242;150;7392;NA;93731;684;2022-01-17;-75641
2022-01-16;"Bratislavský kraj";300;2854;77;2931;NA;93731;377;2022-01-16;-76325
2022-01-15;"Bratislavský kraj";543;2139;71;2210;NA;93731;614;2022-01-15;-76702
2022-01-14;"Bratislavský kraj";356;3692;70;3762;NA;93731;426;2022-01-14;-77316
2022-01-13;"Bratislavský kraj";382;4579;82;4661;NA;93731;464;2022-01-13;-77742
2022-01-12;"Bratislavský kraj";415;4014;71;4085;NA;93731;486;2022-01-12;-78206
2022-01-11;"Bratislavský kraj";407;4910;110;5020;NA;93731;517;2022-01-11;-78692
2022-01-10;"Bratislavský kraj";413;6380;101;6481;NA;93731;514;2022-01-10;-79209
2022-01-09;"Bratislavský kraj";187;3080;71;3151;NA;93731;258;2022-01-09;-79723
2022-01-08;"Bratislavský kraj";323;1951;58;2009;NA;93731;381;2022-01-08;-79981
2022-01-07;"Bratislavský kraj";436;3809;100;3909;NA;93731;536;2022-01-07;-80362
2022-01-06;"Bratislavský kraj";192;2163;51;2214;NA;93731;243;2022-01-06;-80898
2022-01-05;"Bratislavský kraj";426;4047;69;4116;NA;93731;495;2022-01-05;-81141
2022-01-04;"Bratislavský kraj";446;4467;101;4568;NA;93731;547;2022-01-04;-81636
2022-01-03;"Bratislavský kraj";578;5672;129;5801;NA;93731;707;2022-01-03;-82183
2022-01-02;"Bratislavský kraj";198;3137;80;3217;NA;93731;278;2022-01-02;-82890
2022-01-01;"Bratislavský kraj";7;1103;36;1139;NA;93731;43;2022-01-01;-83168
2021-12-31;"Bratislavský kraj";371;3443;92;3535;NA;93731;463;2021-12-31;-83211
2021-12-30;"Bratislavský kraj";468;3619;119;3738;NA;93731;587;2021-12-30;-83674
2021-12-29;"Bratislavský kraj";404;3598;85;3683;NA;93731;489;2021-12-29;-84261
2021-12-28;"Bratislavský kraj";578;4329;121;4450;NA;93731;699;2021-12-28;-84750
2021-12-27;"Bratislavský kraj";656;4693;108;4801;NA;93731;764;2021-12-27;-85449
2021-12-26;"Bratislavský kraj";198;2549;83;2632;NA;93731;281;2021-12-26;-86213
2021-12-25;"Bratislavský kraj";34;1160;53;1213;NA;93731;87;2021-12-25;-86494
2021-12-24;"Bratislavský kraj";171;2214;55;2269;NA;93731;226;2021-12-24;-86581
2021-12-23;"Bratislavský kraj";678;4134;115;4249;NA;93731;793;2021-12-23;-86807
2021-12-22;"Bratislavský kraj";575;4919;118;5037;NA;93731;693;2021-12-22;-87600
2021-12-21;"Bratislavský kraj";625;5628;167;5795;NA;93731;792;2021-12-21;-88293
2021-12-20;"Bratislavský kraj";528;6163;158;6321;NA;93731;686;2021-12-20;-89085
2021-12-19;"Bratislavský kraj";250;3042;98;3140;NA;93731;348;2021-12-19;-89771
2021-12-18;"Bratislavský kraj";528;2654;103;2757;NA;93731;631;2021-12-18;-90119
2021-12-17;"Bratislavský kraj";683;4917;145;5062;NA;93731;828;2021-12-17;-90750
2021-12-16;"Bratislavský kraj";730;5576;162;5738;NA;93731;892;2021-12-16;-91578
2021-12-15;"Bratislavský kraj";881;4884;158;5042;NA;93731;1039;2021-12-15;-92470
2021-12-14;"Bratislavský kraj";869;5397;179;5576;NA;93731;1048;2021-12-14;-93509
2021-12-13;"Bratislavský kraj";648;7614;239;7853;NA;93731;887;2021-12-13;-94557
2021-12-12;"Bratislavský kraj";534;3474;129;3603;NA;93731;663;2021-12-12;-95444
2021-12-11;"Bratislavský kraj";698;2377;153;2530;NA;93731;851;2021-12-11;-96107
2021-12-10;"Bratislavský kraj";796;4728;186;4914;NA;93731;982;2021-12-10;-96958
2021-12-09;"Bratislavský kraj";1040;4152;174;4326;NA;93731;1214;2021-12-09;-97940
2021-12-08;"Bratislavský kraj";1172;4602;196;4798;NA;93731;1368;2021-12-08;-99154
2021-12-07;"Bratislavský kraj";1236;5173;257;5430;NA;93731;1493;2021-12-07;-100522
2021-12-06;"Bratislavský kraj";1434;8714;312;9026;NA;93731;1746;2021-12-06;-102015
2021-12-05;"Bratislavský kraj";633;3874;197;4071;NA;93731;830;2021-12-05;-103761
2021-12-04;"Bratislavský kraj";936;4332;195;4527;NA;93731;1131;2021-12-04;-104591
2021-12-03;"Bratislavský kraj";1222;4351;269;4620;NA;93731;1491;2021-12-03;-105722
2021-12-02;"Bratislavský kraj";2053;5097;311;5408;NA;93731;2364;2021-12-02;-107213
2021-12-01;"Bratislavský kraj";1161;9058;295;9353;NA;93731;1456;2021-12-01;-109577
2021-11-30;"Bratislavský kraj";1442;6508;355;6863;NA;93731;1797;2021-11-30;-111033
2021-11-29;"Bratislavský kraj";863;8823;452;9275;NA;93731;1315;2021-11-29;-112830
2021-11-28;"Bratislavský kraj";617;5102;295;5397;NA;93731;912;2021-11-28;-114145
2021-11-27;"Bratislavský kraj";1026;3497;329;3826;NA;93731;1355;2021-11-27;-115057
2021-11-26;"Bratislavský kraj";1346;5483;422;5905;NA;93731;1768;2021-11-26;-116412
2021-11-25;"Bratislavský kraj";1415;6383;451;6834;NA;93731;1866;2021-11-25;-118180
2021-11-24;"Bratislavský kraj";1286;6849;467;7316;NA;93731;1753;2021-11-24;-120046
2021-11-23;"Bratislavský kraj";1651;6351;433;6784;NA;93731;2084;2021-11-23;-121799
2021-11-22;"Bratislavský kraj";1197;8722;584;9306;NA;93731;1781;2021-11-22;-123883
2021-11-21;"Bratislavský kraj";702;4324;320;4644;NA;93731;1022;2021-11-21;-125664
2021-11-20;"Bratislavský kraj";1005;3514;360;3874;NA;93731;1365;2021-11-20;-126686
2021-11-19;"Bratislavský kraj";1444;5927;549;6476;NA;93731;1993;2021-11-19;-128051
2021-11-18;"Bratislavský kraj";1052;6358;548;6906;NA;93731;1600;2021-11-18;-130044
2021-11-17;"Bratislavský kraj";832;2439;308;2747;NA;93731;1140;2021-11-17;-131644
2021-11-16;"Bratislavský kraj";1067;5792;443;6235;NA;93731;1510;2021-11-16;-132784
2021-11-15;"Bratislavský kraj";1014;6330;519;6849;NA;93731;1533;2021-11-15;-134294
2021-11-14;"Bratislavský kraj";448;3202;335;3537;NA;93731;783;2021-11-14;-135827
2021-11-13;"Bratislavský kraj";587;3251;313;3564;NA;93731;900;2021-11-13;-136610
2021-11-12;"Bratislavský kraj";856;5723;357;6080;NA;93731;1213;2021-11-12;-137510
2021-11-11;"Bratislavský kraj";787;6028;355;6383;NA;93731;1142;2021-11-11;-138723
2021-11-10;"Bratislavský kraj";840;5903;385;6288;NA;93731;1225;2021-11-10;-139865
2021-11-09;"Bratislavský kraj";939;5733;350;6083;NA;93731;1289;2021-11-09;-141090
2021-11-08;"Bratislavský kraj";579;5641;404;6045;NA;93731;983;2021-11-08;-142379
2021-11-07;"Bratislavský kraj";363;2836;244;3080;NA;93731;607;2021-11-07;-143362
2021-11-06;"Bratislavský kraj";538;2901;243;3144;NA;93731;781;2021-11-06;-143969
2021-11-05;"Bratislavský kraj";801;5640;318;5958;NA;93731;1119;2021-11-05;-144750
2021-11-04;"Bratislavský kraj";768;5233;273;5506;NA;93731;1041;2021-11-04;-145869
2021-11-03;"Bratislavský kraj";690;5120;290;5410;NA;93731;980;2021-11-03;-146910
2021-11-02;"Bratislavský kraj";422;6356;327;6683;NA;93731;749;2021-11-02;-147890
2021-11-01;"Bratislavský kraj";395;1733;136;1869;NA;93731;531;2021-11-01;-148639
2021-10-31;"Bratislavský kraj";209;2280;163;2443;NA;93731;372;2021-10-31;-149170
2021-10-30;"Bratislavský kraj";429;2138;118;2256;NA;93731;547;2021-10-30;-149542
2021-10-29;"Bratislavský kraj";445;4757;219;4976;NA;93731;664;2021-10-29;-150089
2021-10-28;"Bratislavský kraj";372;4777;179;4956;NA;93731;551;2021-10-28;-150753
2021-10-27;"Bratislavský kraj";376;4522;164;4686;NA;93731;540;2021-10-27;-151304
2021-10-26;"Bratislavský kraj";461;4492;188;4680;NA;93731;649;2021-10-26;-151844
2021-10-25;"Bratislavský kraj";379;5347;192;5539;NA;93731;571;2021-10-25;-152493
2021-10-24;"Bratislavský kraj";114;2369;91;2460;NA;93731;205;2021-10-24;-153064
2021-10-23;"Bratislavský kraj";301;2666;91;2757;NA;93731;392;2021-10-23;-153269
2021-10-22;"Bratislavský kraj";309;4466;122;4588;NA;93731;431;2021-10-22;-153661
2021-10-21;"Bratislavský kraj";244;4544;101;4645;NA;93731;345;2021-10-21;-154092
2021-10-20;"Bratislavský kraj";262;3897;95;3992;NA;93731;357;2021-10-20;-154437
2021-10-19;"Bratislavský kraj";260;4116;68;4184;NA;93731;328;2021-10-19;-154794
2021-10-18;"Bratislavský kraj";250;5014;114;5128;NA;93731;364;2021-10-18;-155122
2021-10-17;"Bratislavský kraj";54;2460;73;2533;NA;93731;127;2021-10-17;-155486
2021-10-16;"Bratislavský kraj";185;2687;63;2750;NA;93731;248;2021-10-16;-155613
2021-10-15;"Bratislavský kraj";169;4200;64;4264;NA;93731;233;2021-10-15;-155861
2021-10-14;"Bratislavský kraj";173;4714;61;4775;NA;93731;234;2021-10-14;-156094
2021-10-13;"Bratislavský kraj";143;3671;76;3747;NA;93731;219;2021-10-13;-156328
2021-10-12;"Bratislavský kraj";183;4037;78;4115;NA;93731;261;2021-10-12;-156547
2021-10-11;"Bratislavský kraj";191;4798;88;4886;NA;93731;279;2021-10-11;-156808
2021-10-10;"Bratislavský kraj";29;2176;43;2219;NA;93731;72;2021-10-10;-157087
2021-10-09;"Bratislavský kraj";141;2419;34;2453;NA;93731;175;2021-10-09;-157159
2021-10-08;"Bratislavský kraj";130;4511;63;4574;NA;93731;193;2021-10-08;-157334
2021-10-07;"Bratislavský kraj";92;4137;61;4198;NA;93731;153;2021-10-07;-157527
2021-10-06;"Bratislavský kraj";147;4028;68;4096;NA;93731;215;2021-10-06;-157680
2021-10-05;"Bratislavský kraj";164;4468;70;4538;NA;93731;234;2021-10-05;-157895
2021-10-04;"Bratislavský kraj";129;4653;79;4732;NA;93731;208;2021-10-04;-158129
2021-10-03;"Bratislavský kraj";41;2144;42;2186;NA;93731;83;2021-10-03;-158337
2021-10-02;"Bratislavský kraj";104;2605;40;2645;NA;93731;144;2021-10-02;-158420
2021-10-01;"Bratislavský kraj";108;4818;57;4875;NA;93731;165;2021-10-01;-158564
2021-09-30;"Bratislavský kraj";90;3854;60;3914;NA;93731;150;2021-09-30;-158729
2021-09-29;"Bratislavský kraj";115;3508;58;3566;NA;93731;173;2021-09-29;-158879
2021-09-28;"Bratislavský kraj";144;4003;48;4051;NA;93731;192;2021-09-28;-159052
2021-09-27;"Bratislavský kraj";123;4427;70;4497;NA;93731;193;2021-09-27;-159244
2021-09-26;"Bratislavský kraj";32;2194;31;2225;NA;93731;63;2021-09-26;-159437
2021-09-25;"Bratislavský kraj";85;2742;38;2780;NA;93731;123;2021-09-25;-159500
2021-09-24;"Bratislavský kraj";82;4212;59;4271;NA;93731;141;2021-09-24;-159623
2021-09-23;"Bratislavský kraj";90;3975;51;4026;NA;93731;141;2021-09-23;-159764
2021-09-22;"Bratislavský kraj";84;3757;63;3820;NA;93731;147;2021-09-22;-159905
2021-09-21;"Bratislavský kraj";95;3574;39;3613;NA;93731;134;2021-09-21;-160052
2021-09-20;"Bratislavský kraj";84;3937;31;3968;NA;93731;115;2021-09-20;-160186
2021-09-19;"Bratislavský kraj";31;1850;28;1878;NA;93731;59;2021-09-19;-160301
2021-09-18;"Bratislavský kraj";60;1989;19;2008;NA;93731;79;2021-09-18;-160360
2021-09-17;"Bratislavský kraj";87;3443;27;3470;NA;93731;114;2021-09-17;-160439
2021-09-16;"Bratislavský kraj";57;3781;43;3824;NA;93731;100;2021-09-16;-160553
2021-09-15;"Bratislavský kraj";41;1104;21;1125;NA;93731;62;2021-09-15;-160653
2021-09-14;"Bratislavský kraj";78;3518;31;3549;NA;93731;109;2021-09-14;-160715
2021-09-13;"Bratislavský kraj";47;3191;28;3219;NA;93731;75;2021-09-13;-160824
2021-09-12;"Bratislavský kraj";13;1713;21;1734;NA;93731;34;2021-09-12;-160899
2021-09-11;"Bratislavský kraj";36;2064;13;2077;NA;93731;49;2021-09-11;-160933
2021-09-10;"Bratislavský kraj";47;3628;18;3646;NA;93731;65;2021-09-10;-160982
2021-09-09;"Bratislavský kraj";50;3010;30;3040;NA;93731;80;2021-09-09;-161047
2021-09-08;"Bratislavský kraj";56;2925;20;2945;NA;93731;76;2021-09-08;-161127
2021-09-07;"Bratislavský kraj";50;3272;18;3290;NA;93731;68;2021-09-07;-161203
2021-09-06;"Bratislavský kraj";63;2821;29;2850;NA;93731;92;2021-09-06;-161271
2021-09-05;"Bratislavský kraj";10;1682;14;1696;NA;93731;24;2021-09-05;-161363
2021-09-04;"Bratislavský kraj";41;2612;11;2623;NA;93731;52;2021-09-04;-161387
2021-09-03;"Bratislavský kraj";55;3016;14;3030;NA;93731;69;2021-09-03;-161439
2021-09-02;"Bratislavský kraj";35;2423;23;2446;NA;93731;58;2021-09-02;-161508
2021-09-01;"Bratislavský kraj";16;929;9;938;NA;93731;25;2021-09-01;-161566
2021-08-31;"Bratislavský kraj";28;5197;22;5219;NA;93731;50;2021-08-31;-161591
2021-08-30;"Bratislavský kraj";24;2403;13;2416;NA;93731;37;2021-08-30;-161641
2021-08-29;"Bratislavský kraj";11;1016;6;1022;NA;93731;17;2021-08-29;-161678
2021-08-28;"Bratislavský kraj";24;1714;11;1725;NA;93731;35;2021-08-28;-161695
2021-08-27;"Bratislavský kraj";19;2850;9;2859;NA;93731;28;2021-08-27;-161730
2021-08-26;"Bratislavský kraj";15;2382;19;2401;NA;93731;34;2021-08-26;-161758
2021-08-25;"Bratislavský kraj";29;1888;10;1898;NA;93731;39;2021-08-25;-161792
2021-08-24;"Bratislavský kraj";22;1785;4;1789;NA;93731;26;2021-08-24;-161831
2021-08-23;"Bratislavský kraj";21;2183;7;2190;NA;93731;28;2021-08-23;-161857
2021-08-22;"Bratislavský kraj";5;1383;8;1391;NA;93731;13;2021-08-22;-161885
2021-08-21;"Bratislavský kraj";18;1681;4;1685;NA;93731;22;2021-08-21;-161898
2021-08-20;"Bratislavský kraj";27;2747;19;2766;NA;93731;46;2021-08-20;-161920
2021-08-19;"Bratislavský kraj";15;2122;9;2131;NA;93731;24;2021-08-19;-161966
2021-08-18;"Bratislavský kraj";16;1659;11;1670;NA;93731;27;2021-08-18;-161990
2021-08-17;"Bratislavský kraj";18;1608;5;1613;NA;93731;23;2021-08-17;-162017
2021-08-16;"Bratislavský kraj";18;2559;12;2571;NA;93731;30;2021-08-16;-162040
2021-08-15;"Bratislavský kraj";3;1169;6;1175;NA;93731;9;2021-08-15;-162070
2021-08-14;"Bratislavský kraj";11;1519;4;1523;NA;93731;15;2021-08-14;-162079
2021-08-13;"Bratislavský kraj";32;2634;7;2641;NA;93731;39;2021-08-13;-162094
2021-08-12;"Bratislavský kraj";16;1824;9;1833;NA;93731;25;2021-08-12;-162133
2021-08-11;"Bratislavský kraj";22;1621;5;1626;NA;93731;27;2021-08-11;-162158
2021-08-10;"Bratislavský kraj";15;1630;7;1637;NA;93731;22;2021-08-10;-162185
2021-08-09;"Bratislavský kraj";35;1927;9;1936;NA;93731;44;2021-08-09;-162207
2021-08-08;"Bratislavský kraj";3;1152;4;1156;NA;93731;7;2021-08-08;-162251
2021-08-07;"Bratislavský kraj";6;1572;9;1581;NA;93731;15;2021-08-07;-162258
2021-08-06;"Bratislavský kraj";9;2510;10;2520;NA;93731;19;2021-08-06;-162273
2021-08-05;"Bratislavský kraj";10;1651;7;1658;NA;93731;17;2021-08-05;-162292
2021-08-04;"Bratislavský kraj";9;1578;0;1578;NA;93731;9;2021-08-04;-162309
2021-08-03;"Bratislavský kraj";11;1507;5;1512;NA;93731;16;2021-08-03;-162318
2021-08-02;"Bratislavský kraj";15;1749;11;1760;NA;93731;26;2021-08-02;-162334
2021-08-01;"Bratislavský kraj";4;1224;8;1232;NA;93731;12;2021-08-01;-162360
2021-07-31;"Bratislavský kraj";7;1623;2;1625;NA;93731;9;2021-07-31;-162372
2021-07-30;"Bratislavský kraj";15;2540;7;2547;NA;93731;22;2021-07-30;-162381
2021-07-29;"Bratislavský kraj";19;1790;7;1797;NA;93731;26;2021-07-29;-162403
2021-07-28;"Bratislavský kraj";8;1538;11;1549;NA;93731;19;2021-07-28;-162429
2021-07-27;"Bratislavský kraj";9;1476;5;1481;NA;93731;14;2021-07-27;-162448
2021-07-26;"Bratislavský kraj";17;1806;7;1813;NA;93731;24;2021-07-26;-162462
2021-07-25;"Bratislavský kraj";4;1411;2;1413;NA;93731;6;2021-07-25;-162486
2021-07-24;"Bratislavský kraj";9;1732;3;1735;NA;93731;12;2021-07-24;-162492
2021-07-23;"Bratislavský kraj";6;2400;3;2403;NA;93731;9;2021-07-23;-162504
2021-07-22;"Bratislavský kraj";12;1944;6;1950;NA;93731;18;2021-07-22;-162513
2021-07-21;"Bratislavský kraj";5;1860;6;1866;NA;93731;11;2021-07-21;-162531
2021-07-20;"Bratislavský kraj";19;1559;1;1560;NA;93731;20;2021-07-20;-162542
2021-07-19;"Bratislavský kraj";15;2259;3;2262;NA;93731;18;2021-07-19;-162562
2021-07-18;"Bratislavský kraj";2;1462;3;1465;NA;93731;5;2021-07-18;-162580
2021-07-17;"Bratislavský kraj";3;1870;2;1872;NA;93731;5;2021-07-17;-162585
2021-07-16;"Bratislavský kraj";8;2834;4;2838;NA;93731;12;2021-07-16;-162590
2021-07-15;"Bratislavský kraj";5;1677;0;1677;NA;93731;5;2021-07-15;-162602
2021-07-14;"Bratislavský kraj";5;1904;3;1907;NA;93731;8;2021-07-14;-162607
2021-07-13;"Bratislavský kraj";4;1584;4;1588;NA;93731;8;2021-07-13;-162615
2021-07-12;"Bratislavský kraj";6;1780;5;1785;NA;93731;11;2021-07-12;-162623
2021-07-11;"Bratislavský kraj";3;1896;3;1899;NA;93731;6;2021-07-11;-162634
2021-07-10;"Bratislavský kraj";5;2240;3;2243;NA;93731;8;2021-07-10;-162640
2021-07-09;"Bratislavský kraj";13;3546;7;3553;NA;93731;20;2021-07-09;-162648
2021-07-08;"Bratislavský kraj";9;2433;4;2437;NA;93731;13;2021-07-08;-162668
2021-07-07;"Bratislavský kraj";5;2792;4;2796;NA;93731;9;2021-07-07;-162681
2021-07-06;"Bratislavský kraj";19;2771;4;2775;NA;93731;23;2021-07-06;-162690
2021-07-05;"Bratislavský kraj";5;2481;5;2486;NA;93731;10;2021-07-05;-162713
2021-07-04;"Bratislavský kraj";3;1824;2;1826;NA;93731;5;2021-07-04;-162723
2021-07-03;"Bratislavský kraj";8;2205;5;2210;NA;93731;13;2021-07-03;-162728
2021-07-02;"Bratislavský kraj";4;2227;4;2231;NA;93731;8;2021-07-02;-162741
2021-07-01;"Bratislavský kraj";6;1809;5;1814;NA;93731;11;2021-07-01;-162749
2021-06-30;"Bratislavský kraj";2;11548;11;11559;NA;93731;13;2021-06-30;-162760
2021-06-29;"Bratislavský kraj";5;6831;7;6838;NA;93731;12;2021-06-29;-162773
2021-06-28;"Bratislavský kraj";16;6654;24;6678;NA;93731;40;2021-06-28;-162785
2021-06-27;"Bratislavský kraj";4;6689;11;6700;NA;93731;15;2021-06-27;-162825
2021-06-26;"Bratislavský kraj";3;8741;6;8747;NA;93731;9;2021-06-26;-162840
2021-06-25;"Bratislavský kraj";7;10285;15;10300;NA;93731;22;2021-06-25;-162849
2021-06-24;"Bratislavský kraj";3;7384;16;7400;NA;93731;19;2021-06-24;-162871
2021-06-23;"Bratislavský kraj";4;7346;12;7358;NA;93731;16;2021-06-23;-162890
2021-06-22;"Bratislavský kraj";6;7244;10;7254;NA;93731;16;2021-06-22;-162906
2021-06-21;"Bratislavský kraj";5;7641;9;7650;NA;93731;14;2021-06-21;-162922
2021-06-20;"Bratislavský kraj";0;7369;5;7374;NA;93731;5;2021-06-20;-162936
2021-06-19;"Bratislavský kraj";3;9226;4;9230;NA;93731;7;2021-06-19;-162941
2021-06-18;"Bratislavský kraj";5;12763;9;12772;NA;93731;14;2021-06-18;-162948
2021-06-17;"Bratislavský kraj";3;8625;13;8638;NA;93731;16;2021-06-17;-162962
2021-06-16;"Bratislavský kraj";3;7105;4;7109;NA;93731;7;2021-06-16;-162978
2021-06-15;"Bratislavský kraj";7;7309;17;7326;NA;93731;24;2021-06-15;-162985
2021-06-14;"Bratislavský kraj";4;8231;9;8240;NA;93731;13;2021-06-14;-163009
2021-06-13;"Bratislavský kraj";2;8791;11;8802;NA;93731;13;2021-06-13;-163022
2021-06-12;"Bratislavský kraj";4;11152;11;11163;NA;93731;15;2021-06-12;-163035
2021-06-11;"Bratislavský kraj";9;13644;21;13665;NA;93731;30;2021-06-11;-163050
2021-06-10;"Bratislavský kraj";12;8637;15;8652;NA;93731;27;2021-06-10;-163080
2021-06-09;"Bratislavský kraj";12;7596;12;7608;NA;93731;24;2021-06-09;-163107
2021-06-08;"Bratislavský kraj";13;7907;29;7936;NA;93731;42;2021-06-08;-163131
2021-06-07;"Bratislavský kraj";13;9247;43;9290;NA;93731;56;2021-06-07;-163173
2021-06-06;"Bratislavský kraj";3;10350;20;10370;NA;93731;23;2021-06-06;-163229
2021-06-05;"Bratislavský kraj";2;12692;15;12707;NA;93731;17;2021-06-05;-163252
2021-06-04;"Bratislavský kraj";10;13846;31;13877;NA;93731;41;2021-06-04;-163269
2021-06-03;"Bratislavský kraj";12;9615;19;9634;NA;93731;31;2021-06-03;-163310
2021-06-02;"Bratislavský kraj";10;8684;17;8701;NA;93731;27;2021-06-02;-163341
2021-06-01;"Bratislavský kraj";3;8812;25;8837;NA;93731;28;2021-06-01;-163368
2021-05-31;"Bratislavský kraj";18;11248;32;11280;NA;93731;50;2021-05-31;-163396
2021-05-30;"Bratislavský kraj";1;11758;17;11775;NA;93731;18;2021-05-30;-163446
2021-05-29;"Bratislavský kraj";4;12245;8;12253;NA;93731;12;2021-05-29;-163464
2021-05-28;"Bratislavský kraj";14;15865;23;15888;NA;93731;37;2021-05-28;-163476
2021-05-27;"Bratislavský kraj";5;11321;18;11339;NA;93731;23;2021-05-27;-163513
2021-05-26;"Bratislavský kraj";20;10709;17;10726;NA;93731;37;2021-05-26;-163536
2021-05-25;"Bratislavský kraj";19;11864;31;11895;NA;93731;50;2021-05-25;-163573
2021-05-24;"Bratislavský kraj";12;12966;23;12989;NA;93731;35;2021-05-24;-163623
2021-05-23;"Bratislavský kraj";7;13074;24;13098;NA;93731;31;2021-05-23;-163658
2021-05-22;"Bratislavský kraj";6;14044;22;14066;NA;93731;28;2021-05-22;-163689
2021-05-21;"Bratislavský kraj";15;18996;22;19018;NA;93731;37;2021-05-21;-163717
2021-05-20;"Bratislavský kraj";15;14112;17;14129;NA;93731;32;2021-05-20;-163754
2021-05-19;"Bratislavský kraj";21;11958;24;11982;NA;93731;45;2021-05-19;-163786
2021-05-18;"Bratislavský kraj";14;13005;33;13038;NA;93731;47;2021-05-18;-163831
2021-05-17;"Bratislavský kraj";15;13854;29;13883;NA;93731;44;2021-05-17;-163878
2021-05-16;"Bratislavský kraj";12;19797;32;19829;NA;93731;44;2021-05-16;-163922
2021-05-15;"Bratislavský kraj";1;18113;30;18143;NA;93731;31;2021-05-15;-163966
2021-05-14;"Bratislavský kraj";15;22228;30;22258;NA;93731;45;2021-05-14;-163997
2021-05-13;"Bratislavský kraj";9;16211;17;16228;NA;93731;26;2021-05-13;-164042
2021-05-12;"Bratislavský kraj";11;14638;28;14666;NA;93731;39;2021-05-12;-164068
2021-05-11;"Bratislavský kraj";29;16741;32;16773;NA;93731;61;2021-05-11;-164107
2021-05-10;"Bratislavský kraj";27;19991;64;20055;NA;93731;91;2021-05-10;-164168
2021-05-09;"Bratislavský kraj";9;29358;32;29390;NA;93731;41;2021-05-09;-164259
2021-05-08;"Bratislavský kraj";5;19451;24;19475;NA;93731;29;2021-05-08;-164300
2021-05-07;"Bratislavský kraj";32;28211;65;28276;NA;93731;97;2021-05-07;-164329
2021-05-06;"Bratislavský kraj";19;20079;52;20131;NA;93731;71;2021-05-06;-164426
2021-05-05;"Bratislavský kraj";29;15526;31;15557;NA;93731;60;2021-05-05;-164497
2021-05-04;"Bratislavský kraj";46;19143;53;19196;NA;93731;99;2021-05-04;-164557
2021-05-03;"Bratislavský kraj";37;22322;64;22386;NA;93731;101;2021-05-03;-164656
2021-05-02;"Bratislavský kraj";38;43064;75;43139;NA;93731;113;2021-05-02;-164757
2021-05-01;"Bratislavský kraj";11;39905;40;39945;NA;93731;51;2021-05-01;-164870
2021-04-30;"Bratislavský kraj";43;47403;82;47485;NA;93731;125;2021-04-30;-164921
2021-04-29;"Bratislavský kraj";48;30257;96;30353;NA;93731;144;2021-04-29;-165046
2021-04-28;"Bratislavský kraj";40;28905;78;28983;NA;93731;118;2021-04-28;-165190
2021-04-27;"Bratislavský kraj";41;30168;52;30220;NA;93731;93;2021-04-27;-165308
2021-04-26;"Bratislavský kraj";59;34733;97;34830;NA;93731;156;2021-04-26;-165401
2021-04-25;"Bratislavský kraj";8;57615;74;57689;NA;93731;82;2021-04-25;-165557
2021-04-24;"Bratislavský kraj";28;74858;66;74924;NA;93731;94;2021-04-24;-165639
2021-04-23;"Bratislavský kraj";70;48614;62;48676;NA;93731;132;2021-04-23;-165733
2021-04-22;"Bratislavský kraj";39;31037;72;31109;NA;93731;111;2021-04-22;-165865
2021-04-21;"Bratislavský kraj";48;30442;62;30504;NA;93731;110;2021-04-21;-165976
2021-04-20;"Bratislavský kraj";58;35216;63;35279;NA;93731;121;2021-04-20;-166086
2021-04-19;"Bratislavský kraj";48;39500;80;39580;NA;93731;128;2021-04-19;-166207
2021-04-18;"Bratislavský kraj";35;62300;76;62376;NA;93731;111;2021-04-18;-166335
2021-04-17;"Bratislavský kraj";13;80359;111;80470;NA;93731;124;2021-04-17;-166446
2021-04-16;"Bratislavský kraj";62;47296;80;47376;NA;93731;142;2021-04-16;-166570
2021-04-15;"Bratislavský kraj";34;32176;74;32250;NA;93731;108;2021-04-15;-166712
2021-04-14;"Bratislavský kraj";65;33961;88;34049;NA;93731;153;2021-04-14;-166820
2021-04-13;"Bratislavský kraj";82;35512;82;35594;NA;93731;164;2021-04-13;-166973
2021-04-12;"Bratislavský kraj";77;42286;115;42401;NA;93731;192;2021-04-12;-167137
2021-04-11;"Bratislavský kraj";42;61151;123;61274;NA;93731;165;2021-04-11;-167329
2021-04-10;"Bratislavský kraj";14;77874;167;78041;NA;93731;181;2021-04-10;-167494
2021-04-09;"Bratislavský kraj";72;41556;97;41653;NA;93731;169;2021-04-09;-167675
2021-04-08;"Bratislavský kraj";71;28866;95;28961;NA;93731;166;2021-04-08;-167844
2021-04-07;"Bratislavský kraj";96;38061;101;38162;NA;93731;197;2021-04-07;-168010
2021-04-06;"Bratislavský kraj";94;56204;179;56383;NA;93731;273;2021-04-06;-168207
2021-04-05;"Bratislavský kraj";85;18538;85;18623;NA;93731;170;2021-04-05;-168480
2021-04-04;"Bratislavský kraj";37;29225;75;29300;NA;93731;112;2021-04-04;-168650
2021-04-03;"Bratislavský kraj";52;79865;220;80085;NA;93731;272;2021-04-03;-168762
2021-04-02;"Bratislavský kraj";33;23790;104;23894;NA;93731;137;2021-04-02;-169034
2021-04-01;"Bratislavský kraj";119;57388;159;57547;NA;93731;278;2021-04-01;-169171
2021-03-31;"Bratislavský kraj";105;46371;177;46548;NA;93731;282;2021-03-31;-169449
2021-03-30;"Bratislavský kraj";100;39599;144;39743;NA;93731;244;2021-03-30;-169731
2021-03-29;"Bratislavský kraj";153;40364;178;40542;NA;93731;331;2021-03-29;-169975
2021-03-28;"Bratislavský kraj";59;53372;137;53509;NA;93731;196;2021-03-28;-170306
2021-03-27;"Bratislavský kraj";53;79834;240;80074;NA;93731;293;2021-03-27;-170502
2021-03-26;"Bratislavský kraj";114;56108;191;56299;NA;93731;305;2021-03-26;-170795
2021-03-25;"Bratislavský kraj";76;36859;172;37031;NA;93731;248;2021-03-25;-171100
2021-03-24;"Bratislavský kraj";120;30567;201;30768;NA;93731;321;2021-03-24;-171348
2021-03-23;"Bratislavský kraj";138;36438;190;36628;NA;93731;328;2021-03-23;-171669
2021-03-22;"Bratislavský kraj";110;42756;220;42976;NA;93731;330;2021-03-22;-171997
2021-03-21;"Bratislavský kraj";54;61299;212;61511;NA;93731;266;2021-03-21;-172327
2021-03-20;"Bratislavský kraj";59;73300;228;73528;NA;93731;287;2021-03-20;-172593
2021-03-19;"Bratislavský kraj";139;54576;257;54833;NA;93731;396;2021-03-19;-172880
2021-03-18;"Bratislavský kraj";142;34611;192;34803;NA;93731;334;2021-03-18;-173276
2021-03-17;"Bratislavský kraj";177;30482;217;30699;NA;93731;394;2021-03-17;-173610
2021-03-16;"Bratislavský kraj";258;36798;287;37085;NA;93731;545;2021-03-16;-174004
2021-03-15;"Bratislavský kraj";180;38226;255;38481;NA;93731;435;2021-03-15;-174549
2021-03-14;"Bratislavský kraj";75;52611;275;52886;NA;93731;350;2021-03-14;-174984
2021-03-13;"Bratislavský kraj";110;81405;341;81746;NA;93731;451;2021-03-13;-175334
2021-03-12;"Bratislavský kraj";152;55233;312;55545;NA;93731;464;2021-03-12;-175785
2021-03-11;"Bratislavský kraj";178;34678;286;34964;NA;93731;464;2021-03-11;-176249
2021-03-10;"Bratislavský kraj";164;31061;280;31341;NA;93731;444;2021-03-10;-176713
2021-03-09;"Bratislavský kraj";242;37687;267;37954;NA;93731;509;2021-03-09;-177157
2021-03-08;"Bratislavský kraj";255;41199;348;41547;NA;93731;603;2021-03-08;-177666
2021-03-07;"Bratislavský kraj";142;52812;301;53113;NA;93731;443;2021-03-07;-178269
2021-03-06;"Bratislavský kraj";79;71821;415;72236;NA;93731;494;2021-03-06;-178712
2021-03-05;"Bratislavský kraj";238;50653;293;50946;NA;93731;531;2021-03-05;-179206
2021-03-04;"Bratislavský kraj";204;34544;344;34888;NA;93731;548;2021-03-04;-179737
2021-03-03;"Bratislavský kraj";250;30527;364;30891;NA;93731;614;2021-03-03;-180285
2021-03-02;"Bratislavský kraj";267;39735;388;40123;NA;93731;655;2021-03-02;-180899
2021-03-01;"Bratislavský kraj";320;38222;432;38654;NA;93731;752;2021-03-01;-181554
2021-02-28;"Bratislavský kraj";184;50323;323;50646;NA;93731;507;2021-02-28;-182306
2021-02-27;"Bratislavský kraj";151;76580;464;77044;NA;93731;615;2021-02-27;-182813
2021-02-26;"Bratislavský kraj";277;47326;401;47727;NA;93731;678;2021-02-26;-183428
2021-02-25;"Bratislavský kraj";277;28769;405;29174;NA;93731;682;2021-02-25;-184106
2021-02-24;"Bratislavský kraj";217;27095;412;27507;NA;93731;629;2021-02-24;-184788
2021-02-23;"Bratislavský kraj";257;31297;395;31692;NA;93731;652;2021-02-23;-185417
2021-02-22;"Bratislavský kraj";353;36607;483;37090;NA;93731;836;2021-02-22;-186069
2021-02-21;"Bratislavský kraj";185;54150;396;54546;NA;93731;581;2021-02-21;-186905
2021-02-20;"Bratislavský kraj";167;74814;550;75364;NA;93731;717;2021-02-20;-187486
2021-02-19;"Bratislavský kraj";280;44882;416;45298;NA;93731;696;2021-02-19;-188203
2021-02-18;"Bratislavský kraj";263;26379;371;26750;NA;93731;634;2021-02-18;-188899
2021-02-17;"Bratislavský kraj";264;22820;316;23136;NA;93731;580;2021-02-17;-189533
2021-02-16;"Bratislavský kraj";289;28262;352;28614;NA;93731;641;2021-02-16;-190113
2021-02-15;"Bratislavský kraj";248;36893;396;37289;NA;93731;644;2021-02-15;-190754
2021-02-14;"Bratislavský kraj";153;47948;323;48271;NA;93731;476;2021-02-14;-191398
2021-02-13;"Bratislavský kraj";173;68589;515;69104;NA;93731;688;2021-02-13;-191874
2021-02-12;"Bratislavský kraj";282;35729;327;36056;NA;93731;609;2021-02-12;-192562
2021-02-11;"Bratislavský kraj";337;24565;285;24850;NA;93731;622;2021-02-11;-193171
2021-02-10;"Bratislavský kraj";314;22944;356;23300;NA;93731;670;2021-02-10;-193793
2021-02-09;"Bratislavský kraj";288;36565;454;37019;NA;93731;742;2021-02-09;-194463
2021-02-08;"Bratislavský kraj";484;31896;397;32293;NA;93731;881;2021-02-08;-195205
2021-02-07;"Bratislavský kraj";243;51290;425;51715;NA;93731;668;2021-02-07;-196086
2021-02-06;"Bratislavský kraj";116;61682;501;62183;NA;93731;617;2021-02-06;-196754
2021-02-05;"Bratislavský kraj";327;27033;375;27408;NA;93731;702;2021-02-05;-197371
2021-02-04;"Bratislavský kraj";555;17260;348;17608;NA;93731;903;2021-02-04;-198073
2021-02-03;"Bratislavský kraj";161;13020;352;13372;NA;93731;513;2021-02-03;-198976
2021-02-02;"Bratislavský kraj";397;25947;480;26427;NA;93731;877;2021-02-02;-199489
2021-02-01;"Bratislavský kraj";221;35541;513;36054;NA;93731;734;2021-02-01;-200366
2021-01-31;"Bratislavský kraj";180;35693;425;36118;NA;93731;605;2021-01-31;-201100
2021-01-30;"Bratislavský kraj";310;49588;521;50109;NA;93731;831;2021-01-30;-201705
2021-01-29;"Bratislavský kraj";344;16568;344;16912;NA;93731;688;2021-01-29;-202536
2021-01-28;"Bratislavský kraj";307;10715;297;11012;NA;93731;604;2021-01-28;-203224
2021-01-27;"Bratislavský kraj";336;22222;345;22567;NA;93731;681;2021-01-27;-203828
2021-01-26;"Bratislavský kraj";297;21894;300;22194;NA;93731;597;2021-01-26;-204509
2021-01-25;"Bratislavský kraj";356;23335;249;23584;NA;93731;605;2021-01-25;-205106
2021-01-24;"Bratislavský kraj";175;37903;404;38307;NA;93731;579;2021-01-24;-205711
2021-01-23;"Bratislavský kraj";396;79453;690;80143;NA;93731;1086;2021-01-23;-206290
2021-01-22;"Bratislavský kraj";199;42055;365;42420;NA;93731;564;2021-01-22;-207376
2021-01-21;"Bratislavský kraj";255;105746;1317;107063;NA;93731;1572;2021-01-21;-207940
2021-01-20;"Bratislavský kraj";360;27289;452;27741;NA;93731;812;2021-01-20;-209512
2021-01-19;"Bratislavský kraj";375;15318;346;15664;NA;93731;721;2021-01-19;-210324
2021-01-18;"Bratislavský kraj";357;12533;707;13240;NA;93731;1064;2021-01-18;-211045
2021-01-17;"Bratislavský kraj";244;482;26;508;NA;93731;270;2021-01-17;-212109
2021-01-16;"Bratislavský kraj";70;3016;156;3172;NA;93731;226;2021-01-16;-212379
2021-01-15;"Bratislavský kraj";251;7896;256;8152;NA;93731;507;2021-01-15;-212605
2021-01-14;"Bratislavský kraj";363;8523;273;8796;NA;93731;636;2021-01-14;-213112
2021-01-13;"Bratislavský kraj";336;8490;327;8817;NA;93731;663;2021-01-13;-213748
2021-01-12;"Bratislavský kraj";450;10509;455;10964;NA;93731;905;2021-01-12;-214411
2021-01-11;"Bratislavský kraj";397;19863;364;20227;NA;93731;761;2021-01-11;-215316
2021-01-10;"Bratislavský kraj";252;1507;79;1586;NA;93731;331;2021-01-10;-216077
2021-01-09;"Bratislavský kraj";351;4721;277;4998;NA;93731;628;2021-01-09;-216408
2021-01-08;"Bratislavský kraj";556;10045;436;10481;NA;93731;992;2021-01-08;-217036
2021-01-07;"Bratislavský kraj";537;6872;352;7224;NA;93731;889;2021-01-07;-218028
2021-01-06;"Bratislavský kraj";271;3329;216;3545;NA;93731;487;2021-01-06;-218917
2021-01-05;"Bratislavský kraj";619;10635;814;11449;NA;93731;1433;2021-01-05;-219404
2021-01-04;"Bratislavský kraj";601;8226;538;8764;NA;93731;1139;2021-01-04;-220837
2021-01-03;"Bratislavský kraj";77;433;41;474;NA;93731;118;2021-01-03;-221976
2021-01-02;"Bratislavský kraj";185;462;57;519;NA;93731;242;2021-01-02;-222094
2021-01-01;"Bratislavský kraj";235;3277;131;3408;NA;93731;366;2021-01-01;-222336
2020-12-31;"Bratislavský kraj";925;14135;519;14654;NA;93731;1444;2020-12-31;-222702
2020-12-30;"Bratislavský kraj";650;9164;533;9697;NA;93731;1183;2020-12-30;-224146
2020-12-29;"Bratislavský kraj";303;10108;699;10807;NA;93731;1002;2020-12-29;-225329
2020-12-28;"Bratislavský kraj";255;7784;473;8257;NA;93731;728;2020-12-28;-226331
2020-12-27;"Bratislavský kraj";160;709;76;785;NA;93731;236;2020-12-27;-227059
2020-12-26;"Bratislavský kraj";75;480;27;507;NA;93731;102;2020-12-26;-227295
2020-12-25;"Bratislavský kraj";114;503;38;541;NA;93731;152;2020-12-25;-227397
2020-12-24;"Bratislavský kraj";536;3367;104;3471;NA;93731;640;2020-12-24;-227549
2020-12-23;"Bratislavský kraj";416;12590;447;13037;NA;93731;863;2020-12-23;-228189
2020-12-22;"Bratislavský kraj";327;14587;699;15286;NA;93731;1026;2020-12-22;-229052
2020-12-21;"Bratislavský kraj";392;14972;1946;16918;NA;93731;2338;2020-12-21;-230078
2020-12-20;"Bratislavský kraj";180;797;57;854;NA;93731;237;2020-12-20;-232416
2020-12-19;"Bratislavský kraj";396;3314;130;3444;NA;93731;526;2020-12-19;-232653
2020-12-18;"Bratislavský kraj";306;9938;345;10283;NA;93731;651;2020-12-18;-233179
2020-12-17;"Bratislavský kraj";502;9739;386;10125;NA;93731;888;2020-12-17;-233830
2020-12-16;"Bratislavský kraj";282;10201;418;10619;NA;93731;700;2020-12-16;-234718
2020-12-15;"Bratislavský kraj";423;10450;454;10904;NA;93731;877;2020-12-15;-235418
2020-12-14;"Bratislavský kraj";279;6793;261;7054;NA;93731;540;2020-12-14;-236295
2020-12-13;"Bratislavský kraj";125;139;10;149;NA;93731;135;2020-12-13;-236835
2020-12-12;"Bratislavský kraj";361;3886;157;4043;NA;93731;518;2020-12-12;-236970
2020-12-11;"Bratislavský kraj";326;6824;235;7059;NA;93731;561;2020-12-11;-237488
2020-12-10;"Bratislavský kraj";286;5279;166;5445;NA;93731;452;2020-12-10;-238049
2020-12-09;"Bratislavský kraj";382;4778;177;4955;NA;93731;559;2020-12-09;-238501
2020-12-08;"Bratislavský kraj";234;6243;207;6450;NA;93731;441;2020-12-08;-239060
2020-12-07;"Bratislavský kraj";272;4639;152;4791;NA;93731;424;2020-12-07;-239501
2020-12-06;"Bratislavský kraj";61;1625;52;1677;NA;93731;113;2020-12-06;-239925
2020-12-05;"Bratislavský kraj";266;2221;41;2262;NA;93731;307;2020-12-05;-240038
2020-12-04;"Bratislavský kraj";200;4954;99;5053;NA;93731;299;2020-12-04;-240345
2020-12-03;"Bratislavský kraj";213;5672;95;5767;NA;93731;308;2020-12-03;-240644
2020-12-02;"Bratislavský kraj";205;3462;103;3565;NA;93731;308;2020-12-02;-240952
2020-12-01;"Bratislavský kraj";255;3889;172;4061;NA;93731;427;2020-12-01;-241260
2020-11-30;"Bratislavský kraj";152;2153;121;2274;NA;93731;273;2020-11-30;-241687
2020-11-29;"Bratislavský kraj";52;201;24;225;NA;93731;76;2020-11-29;-241960
2020-11-28;"Bratislavský kraj";232;2624;33;2657;NA;93731;265;2020-11-28;-242036
2020-11-27;"Bratislavský kraj";54;2540;64;2604;NA;93731;118;2020-11-27;-242301
2020-11-26;"Bratislavský kraj";129;1976;60;2036;NA;93731;189;2020-11-26;-242419
2020-11-25;"Bratislavský kraj";140;1770;47;1817;NA;93731;187;2020-11-25;-242608
2020-11-24;"Bratislavský kraj";81;2988;67;3055;NA;93731;148;2020-11-24;-242795
2020-11-23;"Bratislavský kraj";67;7083;58;7141;NA;93731;125;2020-11-23;-242943
2020-11-22;"Bratislavský kraj";36;81;7;88;NA;93731;43;2020-11-22;-243068
2020-11-21;"Bratislavský kraj";109;2126;47;2173;NA;93731;156;2020-11-21;-243111
2020-11-20;"Bratislavský kraj";118;2876;48;2924;NA;93731;166;2020-11-20;-243267
2020-11-19;"Bratislavský kraj";173;987;29;1016;NA;93731;202;2020-11-19;-243433
2020-11-18;"Bratislavský kraj";118;616;75;691;NA;93731;193;2020-11-18;-243635
2020-11-17;"Bratislavský kraj";108;928;23;951;NA;93731;131;2020-11-17;-243828
2020-11-16;"Bratislavský kraj";82;651;9;660;NA;93731;91;2020-11-16;-243959
2020-11-15;"Bratislavský kraj";47;236;0;236;NA;93731;47;2020-11-15;-244050
2020-11-14;"Bratislavský kraj";53;1834;15;1849;NA;93731;68;2020-11-14;-244097
2020-11-13;"Bratislavský kraj";94;2096;21;2117;NA;93731;115;2020-11-13;-244165
2020-11-12;"Bratislavský kraj";141;1727;6;1733;NA;93731;147;2020-11-12;-244280
2020-11-11;"Bratislavský kraj";159;1429;12;1441;NA;93731;171;2020-11-11;-244427
2020-11-10;"Bratislavský kraj";136;805;14;819;NA;93731;150;2020-11-10;-244598
2020-11-09;"Bratislavský kraj";70;616;8;624;NA;93731;78;2020-11-09;-244748
2020-11-08;"Bratislavský kraj";82;869;6;875;NA;93731;88;2020-11-08;-244826
2020-11-07;"Bratislavský kraj";88;4039;17;4056;NA;93731;105;2020-11-07;-244914
2020-11-06;"Bratislavský kraj";281;6441;25;6466;NA;93731;306;2020-11-06;-245019
2020-11-05;"Bratislavský kraj";175;476;11;487;NA;93731;186;2020-11-05;-245325
2020-11-04;"Bratislavský kraj";65;411;10;421;NA;93731;75;2020-11-04;-245511
2020-11-03;"Bratislavský kraj";251;1085;12;1097;NA;93731;263;2020-11-03;-245586
2020-11-02;"Bratislavský kraj";202;3365;22;3387;NA;93731;224;2020-11-02;-245849
2020-11-01;"Bratislavský kraj";227;8694;39;8733;NA;93731;266;2020-11-01;-246073
2020-10-31;"Bratislavský kraj";173;22407;123;22530;NA;93731;296;2020-10-31;-246339
2020-10-30;"Bratislavský kraj";158;17350;138;17488;NA;93731;296;2020-10-30;-246635
2020-10-29;"Bratislavský kraj";262;116;4;120;NA;93731;266;2020-10-29;-246931
2020-10-28;"Bratislavský kraj";220;260;15;275;NA;93731;235;2020-10-28;-247197
2020-10-27;"Bratislavský kraj";256;145;4;149;NA;93731;260;2020-10-27;-247432
2020-10-26;"Bratislavský kraj";123;229;11;240;NA;93731;134;2020-10-26;-247692
2020-10-25;"Bratislavský kraj";152;33;2;35;NA;93731;154;2020-10-25;-247826
2020-10-24;"Bratislavský kraj";170;221;6;227;NA;93731;176;2020-10-24;-247980
2020-10-23;"Bratislavský kraj";151;144;8;152;NA;93731;159;2020-10-23;-248156
2020-10-22;"Bratislavský kraj";192;204;15;219;NA;93731;207;2020-10-22;-248315
2020-10-21;"Bratislavský kraj";66;90;6;96;NA;93731;72;2020-10-21;-248522
2020-10-20;"Bratislavský kraj";183;97;4;101;NA;93731;187;2020-10-20;-248594
2020-10-19;"Bratislavský kraj";148;80;3;83;NA;93731;151;2020-10-19;-248781
2020-10-18;"Bratislavský kraj";75;92;0;92;NA;93731;75;2020-10-18;-248932
2020-10-17;"Bratislavský kraj";136;0;0;0;NA;93731;136;2020-10-17;-249007
2020-10-16;"Bratislavský kraj";103;14;1;15;NA;93731;104;2020-10-16;-249143
2020-10-15;"Bratislavský kraj";135;6;1;7;NA;93731;136;2020-10-15;-249247
2020-10-14;"Bratislavský kraj";127;4;0;4;NA;93731;127;2020-10-14;-249383
2020-10-13;"Bratislavský kraj";86;108;8;116;NA;93731;94;2020-10-13;-249510
2020-10-12;"Bratislavský kraj";46;0;0;0;NA;93731;46;2020-10-12;-249604
2020-10-11;"Bratislavský kraj";80;0;0;0;NA;93731;80;2020-10-11;-249650
2020-10-10;"Bratislavský kraj";55;0;0;0;NA;93731;55;2020-10-10;-249730
2020-10-09;"Bratislavský kraj";148;0;0;0;NA;93731;148;2020-10-09;-249785
2020-10-08;"Bratislavský kraj";100;0;0;0;NA;93731;100;2020-10-08;-249933
2020-10-07;"Bratislavský kraj";107;0;0;0;NA;93731;107;2020-10-07;-250033
2020-10-06;"Bratislavský kraj";108;0;0;0;NA;93731;108;2020-10-06;-250140
2020-10-05;"Bratislavský kraj";30;0;0;0;NA;93731;30;2020-10-05;-250248
2020-10-04;"Bratislavský kraj";49;0;0;0;NA;93731;49;2020-10-04;-250278
2020-10-03;"Bratislavský kraj";82;0;0;0;NA;93731;82;2020-10-03;-250327
2020-10-02;"Bratislavský kraj";101;0;0;0;NA;93731;101;2020-10-02;-250409
2020-10-01;"Bratislavský kraj";72;0;0;0;NA;93731;72;2020-10-01;-250510
2020-09-30;"Bratislavský kraj";91;0;0;0;NA;93731;91;2020-09-30;-250582
2020-09-29;"Bratislavský kraj";74;0;0;0;NA;93731;74;2020-09-29;-250673
2020-09-28;"Bratislavský kraj";29;0;0;0;NA;93731;29;2020-09-28;-250747
2020-09-27;"Bratislavský kraj";48;0;0;0;NA;93731;48;2020-09-27;-250776
2020-09-26;"Bratislavský kraj";86;0;0;0;NA;93731;86;2020-09-26;-250824
2020-09-25;"Bratislavský kraj";97;0;0;0;NA;93731;97;2020-09-25;-250910
2020-09-24;"Bratislavský kraj";73;0;0;0;NA;93731;73;2020-09-24;-251007
2020-09-23;"Bratislavský kraj";55;0;0;0;NA;93731;55;2020-09-23;-251080
2020-09-22;"Bratislavský kraj";81;0;0;0;NA;93731;81;2020-09-22;-251135
2020-09-21;"Bratislavský kraj";32;0;0;0;NA;93731;32;2020-09-21;-251216
2020-09-20;"Bratislavský kraj";25;0;0;0;NA;93731;25;2020-09-20;-251248
2020-09-19;"Bratislavský kraj";59;0;0;0;NA;93731;59;2020-09-19;-251273
2020-09-18;"Bratislavský kraj";42;0;0;0;NA;93731;42;2020-09-18;-251332
2020-09-17;"Bratislavský kraj";52;0;0;0;NA;93731;52;2020-09-17;-251374
2020-09-16;"Bratislavský kraj";32;0;0;0;NA;93731;32;2020-09-16;-251426
2020-09-15;"Bratislavský kraj";26;0;0;0;NA;93731;26;2020-09-15;-251458
2020-09-14;"Bratislavský kraj";24;0;0;0;NA;93731;24;2020-09-14;-251484
2020-09-13;"Bratislavský kraj";11;0;0;0;NA;93731;11;2020-09-13;-251508
2020-09-12;"Bratislavský kraj";24;0;0;0;NA;93731;24;2020-09-12;-251519
2020-09-11;"Bratislavský kraj";50;0;0;0;NA;93731;50;2020-09-11;-251543
2020-09-10;"Bratislavský kraj";47;0;0;0;NA;93731;47;2020-09-10;-251593
2020-09-09;"Bratislavský kraj";40;0;0;0;NA;93731;40;2020-09-09;-251640
2020-09-08;"Bratislavský kraj";58;0;0;0;NA;93731;58;2020-09-08;-251680
2020-09-07;"Bratislavský kraj";39;0;0;0;NA;93731;39;2020-09-07;-251738
2020-09-06;"Bratislavský kraj";11;0;0;0;NA;93731;11;2020-09-06;-251777
2020-09-05;"Bratislavský kraj";37;0;0;0;NA;93731;37;2020-09-05;-251788
2020-09-04;"Bratislavský kraj";87;0;0;0;NA;93731;87;2020-09-04;-251825
2020-09-03;"Bratislavský kraj";51;0;0;0;NA;93731;51;2020-09-03;-251912
2020-09-02;"Bratislavský kraj";50;0;0;0;NA;93731;50;2020-09-02;-251963
2020-09-01;"Bratislavský kraj";16;0;0;0;NA;93731;16;2020-09-01;-252013
2020-08-31;"Bratislavský kraj";19;0;0;0;NA;93731;19;2020-08-31;-252029
2020-08-30;"Bratislavský kraj";9;0;0;0;NA;93731;9;2020-08-30;-252048
2020-08-29;"Bratislavský kraj";12;0;0;0;NA;93731;12;2020-08-29;-252057
2020-08-28;"Bratislavský kraj";35;0;0;0;NA;93731;35;2020-08-28;-252069
2020-08-27;"Bratislavský kraj";33;0;0;0;NA;93731;33;2020-08-27;-252104
2020-08-26;"Bratislavský kraj";27;0;0;0;NA;93731;27;2020-08-26;-252137
2020-08-25;"Bratislavský kraj";29;0;0;0;NA;93731;29;2020-08-25;-252164
2020-08-24;"Bratislavský kraj";6;0;0;0;NA;93731;6;2020-08-24;-252193
2020-08-23;"Bratislavský kraj";45;0;0;0;NA;93731;45;2020-08-23;-252199
2020-08-22;"Bratislavský kraj";13;0;0;0;NA;93731;13;2020-08-22;-252244
2020-08-21;"Bratislavský kraj";46;0;0;0;NA;93731;46;2020-08-21;-252257
2020-08-20;"Bratislavský kraj";41;0;0;0;NA;93731;41;2020-08-20;-252303
2020-08-19;"Bratislavský kraj";27;0;0;0;NA;93731;27;2020-08-19;-252344
2020-08-18;"Bratislavský kraj";47;0;0;0;NA;93731;47;2020-08-18;-252371
2020-08-17;"Bratislavský kraj";2;0;0;0;NA;93731;2;2020-08-17;-252418
2020-08-16;"Bratislavský kraj";3;0;0;0;NA;93731;3;2020-08-16;-252420
2020-08-15;"Bratislavský kraj";18;0;0;0;NA;93731;18;2020-08-15;-252423
2020-08-14;"Bratislavský kraj";16;0;0;0;NA;93731;16;2020-08-14;-252441
2020-08-13;"Bratislavský kraj";12;0;0;0;NA;93731;12;2020-08-13;-252457
2020-08-12;"Bratislavský kraj";10;0;0;0;NA;93731;10;2020-08-12;-252469
2020-08-11;"Bratislavský kraj";23;0;0;0;NA;93731;23;2020-08-11;-252479
2020-08-10;"Bratislavský kraj";2;0;0;0;NA;93731;2;2020-08-10;-252502
2020-08-09;"Bratislavský kraj";2;0;0;0;NA;93731;2;2020-08-09;-252504
2020-08-08;"Bratislavský kraj";1;0;0;0;NA;93731;1;2020-08-08;-252506
2020-08-07;"Bratislavský kraj";9;0;0;0;NA;93731;9;2020-08-07;-252507
2020-08-06;"Bratislavský kraj";15;0;0;0;NA;93731;15;2020-08-06;-252516
2020-08-05;"Bratislavský kraj";11;0;0;0;NA;93731;11;2020-08-05;-252531
2020-08-04;"Bratislavský kraj";21;0;0;0;NA;93731;21;2020-08-04;-252542
2020-08-03;"Bratislavský kraj";7;0;0;0;NA;93731;7;2020-08-03;-252563
2020-08-02;"Bratislavský kraj";0;0;0;0;NA;93731;0;2020-08-02;-252570
2020-08-01;"Bratislavský kraj";0;0;0;0;NA;93731;0;2020-08-01;-252570
2020-07-31;"Bratislavský kraj";14;0;0;0;NA;93731;14;2020-07-31;-252570
2020-07-30;"Bratislavský kraj";6;0;0;0;NA;93731;6;2020-07-30;-252584
2020-07-29;"Bratislavský kraj";7;0;0;0;NA;93731;7;2020-07-29;-252590
2020-07-28;"Bratislavský kraj";14;0;0;0;NA;93731;14;2020-07-28;-252597
2020-07-27;"Bratislavský kraj";3;0;0;0;NA;93731;3;2020-07-27;-252611
2020-07-26;"Bratislavský kraj";0;0;0;0;NA;93731;0;2020-07-26;-252614
2020-07-25;"Bratislavský kraj";8;0;0;0;NA;93731;8;2020-07-25;-252614
2020-07-24;"Bratislavský kraj";2;0;0;0;NA;93731;2;2020-07-24;-252622
2020-07-23;"Bratislavský kraj";8;0;0;0;NA;93731;8;2020-07-23;-252624
2020-07-22;"Bratislavský kraj";11;0;0;0;NA;93731;11;2020-07-22;-252632
2020-07-21;"Bratislavský kraj";8;0;0;0;NA;93731;8;2020-07-21;-252643
2020-07-20;"Bratislavský kraj";12;0;0;0;NA;93731;12;2020-07-20;-252651
2020-07-19;"Bratislavský kraj";0;0;0;0;NA;93731;0;2020-07-19;-252663
2020-07-18;"Bratislavský kraj";2;0;0;0;NA;93731;2;2020-07-18;-252663
2020-07-17;"Bratislavský kraj";2;0;0;0;NA;93731;2;2020-07-17;-252665
2020-07-16;"Bratislavský kraj";6;0;0;0;NA;93731;6;2020-07-16;-252667
2020-07-15;"Bratislavský kraj";3;0;0;0;NA;93731;3;2020-07-15;-252673
2020-07-14;"Bratislavský kraj";2;0;0;0;NA;93731;2;2020-07-14;-252676
2020-07-13;"Bratislavský kraj";2;0;0;0;NA;93731;2;2020-07-13;-252678
2020-07-12;"Bratislavský kraj";0;0;0;0;NA;93731;0;2020-07-12;-252680
2020-07-11;"Bratislavský kraj";0;0;0;0;NA;93731;0;2020-07-11;-252680
2020-07-10;"Bratislavský kraj";8;0;0;0;NA;93731;8;2020-07-10;-252680
2020-07-09;"Bratislavský kraj";2;0;0;0;NA;93731;2;2020-07-09;-252688
2020-07-08;"Bratislavský kraj";11;0;0;0;NA;93731;11;2020-07-08;-252690
2020-07-07;"Bratislavský kraj";5;0;0;0;NA;93731;5;2020-07-07;-252701
2020-07-06;"Bratislavský kraj";1;0;0;0;NA;93731;1;2020-07-06;-252706
2020-07-05;"Bratislavský kraj";0;0;0;0;NA;93731;0;2020-07-05;-252707
2020-07-04;"Bratislavský kraj";3;0;0;0;NA;93731;3;2020-07-04;-252707
2020-07-03;"Bratislavský kraj";1;0;0;0;NA;93731;1;2020-07-03;-252710
2020-07-02;"Bratislavský kraj";0;0;0;0;NA;93731;0;2020-07-02;-252711
2020-07-01;"Bratislavský kraj";7;0;0;0;NA;93731;7;2020-07-01;-252711
2020-06-30;"Bratislavský kraj";3;0;0;0;NA;93731;3;2020-06-30;-252718
2020-06-29;"Bratislavský kraj";1;0;0;0;NA;93731;1;2020-06-29;-252721
2020-06-28;"Bratislavský kraj";0;0;0;0;NA;93731;0;2020-06-28;-252722
2020-06-27;"Bratislavský kraj";1;0;0;0;NA;93731;1;2020-06-27;-252722
2020-06-26;"Bratislavský kraj";6;0;0;0;NA;93731;6;2020-06-26;-252723
2020-06-25;"Bratislavský kraj";0;0;0;0;NA;93731;0;2020-06-25;-252729
2020-06-24;"Bratislavský kraj";3;0;0;0;NA;93731;3;2020-06-24;-252729
2020-06-23;"Bratislavský kraj";0;0;0;0;NA;93731;0;2020-06-23;-252732
2020-06-22;"Bratislavský kraj";1;0;0;0;NA;93731;1;2020-06-22;-252732
2020-06-21;"Bratislavský kraj";0;0;0;0;NA;93731;0;2020-06-21;-252733
2020-06-20;"Bratislavský kraj";0;0;0;0;NA;93731;0;2020-06-20;-252733
2020-06-19;"Bratislavský kraj";3;0;0;0;NA;93731;3;2020-06-19;-252733
2020-06-18;"Bratislavský kraj";0;0;0;0;NA;93731;0;2020-06-18;-252736
2020-06-17;"Bratislavský kraj";0;0;0;0;NA;93731;0;2020-06-17;-252736
2020-06-16;"Bratislavský kraj";0;0;0;0;NA;93731;0;2020-06-16;-252736
2020-06-14;"Bratislavský kraj";2;0;0;0;NA;93731;2;2020-06-14;-252736
2020-06-13;"Bratislavský kraj";1;0;0;0;NA;93731;1;2020-06-13;-252738
2020-06-12;"Bratislavský kraj";2;0;0;0;NA;93731;2;2020-06-12;-252739
2020-06-11;"Bratislavský kraj";0;0;0;0;NA;93731;0;2020-06-11;-252741
2020-06-10;"Bratislavský kraj";0;0;0;0;NA;93731;0;2020-06-10;-252741
2020-06-09;"Bratislavský kraj";0;0;0;0;NA;93731;0;2020-06-09;-252741
2020-06-08;"Bratislavský kraj";1;0;0;0;NA;93731;1;2020-06-08;-252741
2020-06-07;"Bratislavský kraj";0;0;0;0;NA;93731;0;2020-06-07;-252742
2020-06-05;"Bratislavský kraj";0;0;0;0;NA;93731;0;2020-06-05;-252742
2020-06-03;"Bratislavský kraj";1;0;0;0;NA;93731;1;2020-06-03;-252742
2020-06-02;"Bratislavský kraj";0;0;0;0;NA;93731;0;2020-06-02;-252743
2020-05-31;"Bratislavský kraj";0;0;0;0;NA;93731;0;2020-05-31;-252743
2020-05-29;"Bratislavský kraj";0;0;0;0;NA;93731;0;2020-05-29;-252743
2020-05-27;"Bratislavský kraj";1;0;0;0;NA;93731;1;2020-05-27;-252743
2020-05-26;"Bratislavský kraj";0;0;0;0;NA;93731;0;2020-05-26;-252744
2020-05-25;"Bratislavský kraj";0;0;0;0;NA;93731;0;2020-05-25;-252744
2020-05-24;"Bratislavský kraj";0;0;0;0;NA;93731;0;2020-05-24;-252744
2020-05-23;"Bratislavský kraj";2;0;0;0;NA;93731;2;2020-05-23;-252744
2020-05-22;"Bratislavský kraj";0;0;0;0;NA;93731;0;2020-05-22;-252746
2020-05-21;"Bratislavský kraj";0;0;0;0;NA;93731;0;2020-05-21;-252746
2020-05-20;"Bratislavský kraj";0;0;0;0;NA;93731;0;2020-05-20;-252746
2020-05-19;"Bratislavský kraj";0;0;0;0;NA;93731;0;2020-05-19;-252746
2020-05-17;"Bratislavský kraj";0;0;0;0;NA;93731;0;2020-05-17;-252746
2020-05-16;"Bratislavský kraj";0;0;0;0;NA;93731;0;2020-05-16;-252746
2020-05-15;"Bratislavský kraj";0;0;0;0;NA;93731;0;2020-05-15;-252746
2020-05-14;"Bratislavský kraj";0;0;0;0;NA;93731;0;2020-05-14;-252746
2020-05-13;"Bratislavský kraj";0;0;0;0;NA;93731;0;2020-05-13;-252746
2020-05-12;"Bratislavský kraj";2;0;0;0;NA;93731;2;2020-05-12;-252746
2020-05-11;"Bratislavský kraj";0;0;0;0;NA;93731;0;2020-05-11;-252748
2020-05-09;"Bratislavský kraj";0;0;0;0;NA;93731;0;2020-05-09;-252748
2020-05-07;"Bratislavský kraj";1;0;0;0;NA;93731;1;2020-05-07;-252748
2020-05-06;"Bratislavský kraj";3;0;0;0;NA;93731;3;2020-05-06;-252749
2020-05-05;"Bratislavský kraj";0;0;0;0;NA;93731;0;2020-05-05;-252752
2020-05-04;"Bratislavský kraj";0;0;0;0;NA;93731;0;2020-05-04;-252752
2020-05-03;"Bratislavský kraj";2;0;0;0;NA;93731;2;2020-05-03;-252752
2020-05-02;"Bratislavský kraj";0;0;0;0;NA;93731;0;2020-05-02;-252754
2020-05-01;"Bratislavský kraj";0;0;0;0;NA;93731;0;2020-05-01;-252754
2020-04-30;"Bratislavský kraj";5;0;0;0;NA;93731;5;2020-04-30;-252754
2020-04-29;"Bratislavský kraj";0;0;0;0;NA;93731;0;2020-04-29;-252759
2020-04-28;"Bratislavský kraj";2;0;0;0;NA;93731;2;2020-04-28;-252759
2020-04-27;"Bratislavský kraj";0;0;0;0;NA;93731;0;2020-04-27;-252761
2020-04-26;"Bratislavský kraj";1;0;0;0;NA;93731;1;2020-04-26;-252761
2020-04-25;"Bratislavský kraj";0;0;0;0;NA;93731;0;2020-04-25;-252762
2020-04-24;"Bratislavský kraj";2;0;0;0;NA;93731;2;2020-04-24;-252762
2020-04-23;"Bratislavský kraj";6;0;0;0;NA;93731;6;2020-04-23;-252764
2020-04-22;"Bratislavský kraj";11;0;0;0;NA;93731;11;2020-04-22;-252770
2020-04-21;"Bratislavský kraj";4;0;0;0;NA;93731;4;2020-04-21;-252781
2020-04-20;"Bratislavský kraj";0;0;0;0;NA;93731;0;2020-04-20;-252785
2020-04-19;"Bratislavský kraj";4;0;0;0;NA;93731;4;2020-04-19;-252785
2020-04-18;"Bratislavský kraj";5;0;0;0;NA;93731;5;2020-04-18;-252789
2020-04-17;"Bratislavský kraj";6;0;0;0;NA;93731;6;2020-04-17;-252794
2020-04-16;"Bratislavský kraj";15;0;0;0;NA;93731;15;2020-04-16;-252800
2020-04-15;"Bratislavský kraj";11;0;0;0;NA;93731;11;2020-04-15;-252815
2020-04-14;"Bratislavský kraj";19;0;0;0;NA;93731;19;2020-04-14;-252826
2020-04-13;"Bratislavský kraj";53;0;0;0;NA;93731;53;2020-04-13;-252845
2020-04-12;"Bratislavský kraj";3;0;0;0;NA;93731;3;2020-04-12;-252898
2020-04-11;"Bratislavský kraj";1;0;0;0;NA;93731;1;2020-04-11;-252901
2020-04-10;"Bratislavský kraj";8;0;0;0;NA;93731;8;2020-04-10;-252902
2020-04-09;"Bratislavský kraj";3;0;0;0;NA;93731;3;2020-04-09;-252910
2020-04-08;"Bratislavský kraj";3;0;0;0;NA;93731;3;2020-04-08;-252913
2020-04-07;"Bratislavský kraj";24;0;0;0;NA;93731;24;2020-04-07;-252916
2020-04-06;"Bratislavský kraj";5;0;0;0;NA;93731;5;2020-04-06;-252940
2020-04-05;"Bratislavský kraj";6;0;0;0;NA;93731;6;2020-04-05;-252945
2020-04-04;"Bratislavský kraj";2;0;0;0;NA;93731;2;2020-04-04;-252951
2020-04-03;"Bratislavský kraj";1;0;0;0;NA;93731;1;2020-04-03;-252953
2020-04-02;"Bratislavský kraj";2;0;0;0;NA;93731;2;2020-04-02;-252954
2020-04-01;"Bratislavský kraj";5;0;0;0;NA;93731;5;2020-04-01;-252956
2020-03-31;"Bratislavský kraj";19;0;0;0;NA;93731;19;2020-03-31;-252961
2020-03-30;"Bratislavský kraj";6;0;0;0;NA;93731;6;2020-03-30;-252980
2020-03-29;"Bratislavský kraj";8;0;0;0;NA;93731;8;2020-03-29;-252986
2020-03-28;"Bratislavský kraj";4;0;0;0;NA;93731;4;2020-03-28;-252994
2020-03-27;"Bratislavský kraj";3;0;0;0;NA;93731;3;2020-03-27;-252998
2020-03-26;"Bratislavský kraj";15;0;0;0;NA;93731;15;2020-03-26;-253001
2020-03-25;"Bratislavský kraj";1;0;0;0;NA;93731;1;2020-03-25;-253016
2020-03-24;"Bratislavský kraj";4;0;0;0;NA;93731;4;2020-03-24;-253017
2020-03-23;"Bratislavský kraj";9;0;0;0;NA;93731;9;2020-03-23;-253021
2020-03-22;"Bratislavský kraj";2;0;0;0;NA;93731;2;2020-03-22;-253030
2020-03-21;"Bratislavský kraj";22;0;0;0;NA;93731;22;2020-03-21;-253032
2020-03-20;"Bratislavský kraj";3;0;0;0;NA;93731;3;2020-03-20;-253054
2020-03-19;"Bratislavský kraj";4;0;0;0;NA;93731;4;2020-03-19;-253057
2020-03-18;"Bratislavský kraj";3;0;0;0;NA;93731;3;2020-03-18;-253061
2020-03-17;"Bratislavský kraj";13;0;0;0;NA;93731;13;2020-03-17;-253064
2020-03-16;"Bratislavský kraj";1;0;0;0;NA;93731;1;2020-03-16;-253077
2020-03-15;"Bratislavský kraj";4;0;0;0;NA;93731;4;2020-03-15;-253078
2020-03-14;"Bratislavský kraj";9;0;0;0;NA;93731;9;2020-03-14;-253082
2020-03-13;"Bratislavský kraj";2;0;0;0;NA;93731;2;2020-03-13;-253091
2020-03-12;"Bratislavský kraj";8;0;0;0;NA;93731;8;2020-03-12;-253093
2020-03-11;"Bratislavský kraj";3;0;0;0;NA;93731;3;2020-03-11;-253101
2020-03-09;"Bratislavský kraj";0;0;0;0;NA;93731;0;2020-03-09;-253104
2020-03-08;"Bratislavský kraj";2;0;0;0;NA;93731;2;2020-03-08;-253104
2020-03-07;"Bratislavský kraj";2;0;0;0;NA;93731;2;2020-03-07;-253106
2020-03-06;"Bratislavský kraj";1;0;0;0;NA;93731;1;2020-03-06;-253108
2022-06-26;"Košický kraj";8;27;9;36;NA;110947;17;2022-06-26;110947
2022-06-25;"Košický kraj";35;45;14;59;NA;110947;49;2022-06-25;110930
2022-06-24;"Košický kraj";52;154;29;183;NA;110947;81;2022-06-24;110881
2022-06-23;"Košický kraj";36;362;20;382;NA;110947;56;2022-06-23;110800
2022-06-22;"Košický kraj";33;205;21;226;NA;110947;54;2022-06-22;110744
2022-06-21;"Košický kraj";42;216;21;237;NA;110947;63;2022-06-21;110690
2022-06-20;"Košický kraj";24;492;35;527;NA;110947;59;2022-06-20;110627
2022-06-19;"Košický kraj";4;37;9;46;NA;110947;13;2022-06-19;110568
2022-06-18;"Košický kraj";11;38;2;40;NA;110947;13;2022-06-18;110555
2022-06-17;"Košický kraj";27;164;13;177;NA;110947;40;2022-06-17;110542
2022-06-16;"Košický kraj";20;360;17;377;NA;110947;37;2022-06-16;110502
2022-06-15;"Košický kraj";27;196;18;214;NA;110947;45;2022-06-15;110465
2022-06-14;"Košický kraj";19;159;14;173;NA;110947;33;2022-06-14;110420
2022-06-13;"Košický kraj";21;246;16;262;NA;110947;37;2022-06-13;110387
2022-06-12;"Košický kraj";4;47;8;55;NA;110947;12;2022-06-12;110350
2022-06-11;"Košický kraj";13;27;3;30;NA;110947;16;2022-06-11;110338
2022-06-10;"Košický kraj";15;189;17;206;NA;110947;32;2022-06-10;110322
2022-06-09;"Košický kraj";15;123;4;127;NA;110947;19;2022-06-09;110290
2022-06-08;"Košický kraj";21;184;13;197;NA;110947;34;2022-06-08;110271
2022-06-07;"Košický kraj";24;2676;4;2680;NA;110947;28;2022-06-07;110237
2022-06-06;"Košický kraj";15;404;29;433;NA;110947;44;2022-06-06;110209
2022-06-05;"Košický kraj";6;69;3;72;NA;110947;9;2022-06-05;110165
2022-06-04;"Košický kraj";16;39;1;40;NA;110947;17;2022-06-04;110156
2022-06-03;"Košický kraj";14;183;13;196;NA;110947;27;2022-06-03;110139
2022-06-02;"Košický kraj";12;383;18;401;NA;110947;30;2022-06-02;110112
2022-06-01;"Košický kraj";22;283;17;300;NA;110947;39;2022-06-01;110082
2022-05-31;"Košický kraj";28;248;11;259;NA;110947;39;2022-05-31;110043
2022-05-30;"Košický kraj";18;778;25;803;NA;110947;43;2022-05-30;110004
2022-05-29;"Košický kraj";5;74;6;80;NA;110947;11;2022-05-29;109961
2022-05-28;"Košický kraj";10;40;4;44;NA;110947;14;2022-05-28;109950
2022-05-27;"Košický kraj";21;186;7;193;NA;110947;28;2022-05-27;109936
2022-05-26;"Košický kraj";27;219;16;235;NA;110947;43;2022-05-26;109908
2022-05-25;"Košický kraj";40;235;10;245;NA;110947;50;2022-05-25;109865
2022-05-24;"Košický kraj";20;248;12;260;NA;110947;32;2022-05-24;109815
2022-05-23;"Košický kraj";20;721;40;761;NA;110947;60;2022-05-23;109783
2022-05-22;"Košický kraj";2;52;9;61;NA;110947;11;2022-05-22;109723
2022-05-21;"Košický kraj";16;52;4;56;NA;110947;20;2022-05-21;109712
2022-05-20;"Košický kraj";30;237;12;249;NA;110947;42;2022-05-20;109692
2022-05-19;"Košický kraj";35;488;13;501;NA;110947;48;2022-05-19;109650
2022-05-18;"Košický kraj";48;257;11;268;NA;110947;59;2022-05-18;109602
2022-05-17;"Košický kraj";49;361;17;378;NA;110947;66;2022-05-17;109543
2022-05-16;"Košický kraj";22;422;29;451;NA;110947;51;2022-05-16;109477
2022-05-15;"Košický kraj";10;205;21;226;NA;110947;31;2022-05-15;109426
2022-05-14;"Košický kraj";38;181;18;199;NA;110947;56;2022-05-14;109395
2022-05-13;"Košický kraj";63;459;32;491;NA;110947;95;2022-05-13;109339
2022-05-12;"Košický kraj";54;393;25;418;NA;110947;79;2022-05-12;109244
2022-05-11;"Košický kraj";44;602;40;642;NA;110947;84;2022-05-11;109165
2022-05-10;"Košický kraj";47;421;41;462;NA;110947;88;2022-05-10;109081
2022-05-09;"Košický kraj";33;663;59;722;NA;110947;92;2022-05-09;108993
2022-05-08;"Košický kraj";9;230;22;252;NA;110947;31;2022-05-08;108901
2022-05-07;"Košický kraj";36;242;16;258;NA;110947;52;2022-05-07;108870
2022-05-06;"Košický kraj";73;453;42;495;NA;110947;115;2022-05-06;108818
2022-05-05;"Košický kraj";66;571;42;613;NA;110947;108;2022-05-05;108703
2022-05-04;"Košický kraj";56;528;40;568;NA;110947;96;2022-05-04;108595
2022-05-03;"Košický kraj";104;776;46;822;NA;110947;150;2022-05-03;108499
2022-05-02;"Košický kraj";97;1285;106;1391;NA;110947;203;2022-05-02;108349
2022-05-01;"Košický kraj";16;249;34;283;NA;110947;50;2022-05-01;108146
2022-04-30;"Košický kraj";106;308;28;336;NA;110947;134;2022-04-30;108096
2022-04-29;"Košický kraj";124;843;49;892;NA;110947;173;2022-04-29;107962
2022-04-28;"Košický kraj";108;1107;72;1179;NA;110947;180;2022-04-28;107789
2022-04-27;"Košický kraj";184;1266;54;1320;NA;110947;238;2022-04-27;107609
2022-04-26;"Košický kraj";160;1786;78;1864;NA;110947;238;2022-04-26;107371
2022-04-25;"Košický kraj";208;1912;121;2033;NA;110947;329;2022-04-25;107133
2022-04-24;"Košický kraj";43;553;59;612;NA;110947;102;2022-04-24;106804
2022-04-23;"Košický kraj";183;497;46;543;NA;110947;229;2022-04-23;106702
2022-04-22;"Košický kraj";237;1202;80;1282;NA;110947;317;2022-04-22;106473
2022-04-21;"Košický kraj";169;1571;110;1681;NA;110947;279;2022-04-21;106156
2022-04-20;"Košický kraj";331;1796;91;1887;NA;110947;422;2022-04-20;105877
2022-04-19;"Košický kraj";306;2580;181;2761;NA;110947;487;2022-04-19;105455
2022-04-18;"Košický kraj";63;715;60;775;NA;110947;123;2022-04-18;104968
2022-04-17;"Košický kraj";163;305;32;337;NA;110947;195;2022-04-17;104845
2022-04-16;"Košický kraj";129;540;88;628;NA;110947;217;2022-04-16;104650
2022-04-15;"Košický kraj";65;410;25;435;NA;110947;90;2022-04-15;104433
2022-04-14;"Košický kraj";364;1677;106;1783;NA;110947;470;2022-04-14;104343
2022-04-13;"Košický kraj";417;1889;104;1993;NA;110947;521;2022-04-13;103873
2022-04-12;"Košický kraj";254;1713;136;1849;NA;110947;390;2022-04-12;103352
2022-04-11;"Košický kraj";418;2765;184;2949;NA;110947;602;2022-04-11;102962
2022-04-10;"Košický kraj";164;795;66;861;NA;110947;230;2022-04-10;102360
2022-04-09;"Košický kraj";210;623;55;678;NA;110947;265;2022-04-09;102130
2022-04-08;"Košický kraj";373;1705;151;1856;NA;110947;524;2022-04-08;101865
2022-04-07;"Košický kraj";428;2176;173;2349;NA;110947;601;2022-04-07;101341
2022-04-06;"Košický kraj";580;1845;172;2017;NA;110947;752;2022-04-06;100740
2022-04-05;"Košický kraj";721;1818;187;2005;NA;110947;908;2022-04-05;99988
2022-04-04;"Košický kraj";694;3029;326;3355;NA;110947;1020;2022-04-04;99080
2022-04-03;"Košický kraj";208;861;136;997;NA;110947;344;2022-04-03;98060
2022-04-02;"Košický kraj";331;628;86;714;NA;110947;417;2022-04-02;97716
2022-04-01;"Košický kraj";714;1919;227;2146;NA;110947;941;2022-04-01;97299
2022-03-31;"Košický kraj";745;1899;205;2104;NA;110947;950;2022-03-31;96358
2022-03-30;"Košický kraj";1081;2171;241;2412;NA;110947;1322;2022-03-30;95408
2022-03-29;"Košický kraj";683;2337;310;2647;NA;110947;993;2022-03-29;94086
2022-03-28;"Košický kraj";886;3310;435;3745;NA;110947;1321;2022-03-28;93093
2022-03-27;"Košický kraj";355;1168;230;1398;NA;110947;585;2022-03-27;91772
2022-03-26;"Košický kraj";593;940;165;1105;NA;110947;758;2022-03-26;91187
2022-03-25;"Košický kraj";958;1831;316;2147;NA;110947;1274;2022-03-25;90429
2022-03-24;"Košický kraj";998;2433;328;2761;NA;110947;1326;2022-03-24;89155
2022-03-23;"Košický kraj";1143;2615;348;2963;NA;110947;1491;2022-03-23;87829
2022-03-22;"Košický kraj";1508;2766;378;3144;NA;110947;1886;2022-03-22;86338
2022-03-21;"Košický kraj";1241;3484;530;4014;NA;110947;1771;2022-03-21;84452
2022-03-20;"Košický kraj";199;1514;318;1832;NA;110947;517;2022-03-20;82681
2022-03-19;"Košický kraj";952;1133;241;1374;NA;110947;1193;2022-03-19;82164
2022-03-18;"Košický kraj";1382;2278;343;2621;NA;110947;1725;2022-03-18;80971
2022-03-17;"Košický kraj";1181;2717;358;3075;NA;110947;1539;2022-03-17;79246
2022-03-16;"Košický kraj";1631;4800;372;5172;NA;110947;2003;2022-03-16;77707
2022-03-15;"Košický kraj";1591;2889;436;3325;NA;110947;2027;2022-03-15;75704
2022-03-14;"Košický kraj";1424;3479;585;4064;NA;110947;2009;2022-03-14;73677
2022-03-13;"Košický kraj";565;1711;375;2086;NA;110947;940;2022-03-13;71668
2022-03-12;"Košický kraj";1227;1263;218;1481;NA;110947;1445;2022-03-12;70728
2022-03-11;"Košický kraj";1451;2815;513;3328;NA;110947;1964;2022-03-11;69283
2022-03-10;"Košický kraj";990;3158;406;3564;NA;110947;1396;2022-03-10;67319
2022-03-09;"Košický kraj";1545;3322;397;3719;NA;110947;1942;2022-03-09;65923
2022-03-08;"Košický kraj";1487;3633;441;4074;NA;110947;1928;2022-03-08;63981
2022-03-07;"Košický kraj";1347;4968;713;5681;NA;110947;2060;2022-03-07;62053
2022-03-06;"Košický kraj";297;1811;372;2183;NA;110947;669;2022-03-06;59993
2022-03-05;"Košický kraj";874;1317;264;1581;NA;110947;1138;2022-03-05;59324
2022-03-04;"Košický kraj";1255;3130;424;3554;NA;110947;1679;2022-03-04;58186
2022-03-03;"Košický kraj";1111;3543;433;3976;NA;110947;1544;2022-03-03;56507
2022-03-02;"Košický kraj";1458;3437;455;3892;NA;110947;1913;2022-03-02;54963
2022-03-01;"Košický kraj";1723;3720;487;4207;NA;110947;2210;2022-03-01;53050
2022-02-28;"Košický kraj";1345;5497;805;6302;NA;110947;2150;2022-02-28;50840
2022-02-27;"Košický kraj";465;2397;440;2837;NA;110947;905;2022-02-27;48690
2022-02-26;"Košický kraj";979;1348;329;1677;NA;110947;1308;2022-02-26;47785
2022-02-25;"Košický kraj";1691;3274;510;3784;NA;110947;2201;2022-02-25;46477
2022-02-24;"Košický kraj";1988;4033;594;4627;NA;110947;2582;2022-02-24;44276
2022-02-23;"Košický kraj";1787;4151;558;4709;NA;110947;2345;2022-02-23;41694
2022-02-22;"Košický kraj";2649;4695;660;5355;NA;110947;3309;2022-02-22;39349
2022-02-21;"Košický kraj";1646;6499;910;7409;NA;110947;2556;2022-02-21;36040
2022-02-20;"Košický kraj";577;2919;578;3497;NA;110947;1155;2022-02-20;33484
2022-02-19;"Košický kraj";1941;2169;409;2578;NA;110947;2350;2022-02-19;32329
2022-02-18;"Košický kraj";2210;4534;640;5174;NA;110947;2850;2022-02-18;29979
2022-02-17;"Košický kraj";2555;4668;675;5343;NA;110947;3230;2022-02-17;27129
2022-02-16;"Košický kraj";2153;5477;736;6213;NA;110947;2889;2022-02-16;23899
2022-02-15;"Košický kraj";2768;5507;830;6337;NA;110947;3598;2022-02-15;21010
2022-02-14;"Košický kraj";2337;8076;1104;9180;NA;110947;3441;2022-02-14;17412
2022-02-13;"Košický kraj";1235;4248;809;5057;NA;110947;2044;2022-02-13;13971
2022-02-12;"Košický kraj";1728;2014;524;2538;NA;110947;2252;2022-02-12;11927
2022-02-11;"Košický kraj";2665;4797;633;5430;NA;110947;3298;2022-02-11;9675
2022-02-10;"Košický kraj";2135;5323;728;6051;NA;110947;2863;2022-02-10;6377
2022-02-09;"Košický kraj";2067;5940;743;6683;NA;110947;2810;2022-02-09;3514
2022-02-08;"Košický kraj";2993;6143;762;6905;NA;110947;3755;2022-02-08;704
2022-02-07;"Košický kraj";1939;7973;978;8951;NA;110947;2917;2022-02-07;-3051
2022-02-06;"Košický kraj";998;4482;680;5162;NA;110947;1678;2022-02-06;-5968
2022-02-05;"Košický kraj";2209;2454;434;2888;NA;110947;2643;2022-02-05;-7646
2022-02-04;"Košický kraj";2563;5634;632;6266;NA;110947;3195;2022-02-04;-10289
2022-02-03;"Košický kraj";1916;6379;659;7038;NA;110947;2575;2022-02-03;-13484
2022-02-02;"Košický kraj";2498;6923;629;7552;NA;110947;3127;2022-02-02;-16059
2022-02-01;"Košický kraj";2173;6706;678;7384;NA;110947;2851;2022-02-01;-19186
2022-01-31;"Košický kraj";2020;9960;841;10801;NA;110947;2861;2022-01-31;-22037
2022-01-30;"Košický kraj";1002;5716;541;6257;NA;110947;1543;2022-01-30;-24898
2022-01-29;"Košický kraj";1731;2720;387;3107;NA;110947;2118;2022-01-29;-26441
2022-01-28;"Košický kraj";1743;5571;492;6063;NA;110947;2235;2022-01-28;-28559
2022-01-27;"Košický kraj";1553;5792;413;6205;NA;110947;1966;2022-01-27;-30794
2022-01-26;"Košický kraj";1683;5613;399;6012;NA;110947;2082;2022-01-26;-32760
2022-01-25;"Košický kraj";1409;6210;404;6614;NA;110947;1813;2022-01-25;-34842
2022-01-24;"Košický kraj";1141;8669;431;9100;NA;110947;1572;2022-01-24;-36655
2022-01-23;"Košický kraj";516;5418;287;5705;NA;110947;803;2022-01-23;-38227
2022-01-22;"Košický kraj";914;2528;177;2705;NA;110947;1091;2022-01-22;-39030
2022-01-21;"Košický kraj";589;5194;227;5421;NA;110947;816;2022-01-21;-40121
2022-01-20;"Košický kraj";769;5379;200;5579;NA;110947;969;2022-01-20;-40937
2022-01-19;"Košický kraj";629;5329;178;5507;NA;110947;807;2022-01-19;-41906
2022-01-18;"Košický kraj";716;5758;140;5898;NA;110947;856;2022-01-18;-42713
2022-01-17;"Košický kraj";486;9004;187;9191;NA;110947;673;2022-01-17;-43569
2022-01-16;"Košický kraj";51;5264;137;5401;NA;110947;188;2022-01-16;-44242
2022-01-15;"Košický kraj";422;2208;69;2277;NA;110947;491;2022-01-15;-44430
2022-01-14;"Košický kraj";175;4208;93;4301;NA;110947;268;2022-01-14;-44921
2022-01-13;"Košický kraj";165;4919;77;4996;NA;110947;242;2022-01-13;-45189
2022-01-12;"Košický kraj";295;4609;78;4687;NA;110947;373;2022-01-12;-45431
2022-01-11;"Košický kraj";349;5295;70;5365;NA;110947;419;2022-01-11;-45804
2022-01-10;"Košický kraj";290;8254;128;8382;NA;110947;418;2022-01-10;-46223
2022-01-09;"Košický kraj";230;5838;86;5924;NA;110947;316;2022-01-09;-46641
2022-01-08;"Košický kraj";157;2417;57;2474;NA;110947;214;2022-01-08;-46957
2022-01-07;"Košický kraj";388;5017;129;5146;NA;110947;517;2022-01-07;-47171
2022-01-06;"Košický kraj";118;1576;55;1631;NA;110947;173;2022-01-06;-47688
2022-01-05;"Košický kraj";354;5082;102;5184;NA;110947;456;2022-01-05;-47861
2022-01-04;"Košický kraj";450;5273;84;5357;NA;110947;534;2022-01-04;-48317
2022-01-03;"Košický kraj";439;7970;140;8110;NA;110947;579;2022-01-03;-48851
2022-01-02;"Košický kraj";284;4614;109;4723;NA;110947;393;2022-01-02;-49430
2022-01-01;"Košický kraj";28;360;18;378;NA;110947;46;2022-01-01;-49823
2021-12-31;"Košický kraj";122;2999;86;3085;NA;110947;208;2021-12-31;-49869
2021-12-30;"Košický kraj";401;3949;118;4067;NA;110947;519;2021-12-30;-50077
2021-12-29;"Košický kraj";378;4194;111;4305;NA;110947;489;2021-12-29;-50596
2021-12-28;"Košický kraj";509;4450;125;4575;NA;110947;634;2021-12-28;-51085
2021-12-27;"Košický kraj";495;6822;205;7027;NA;110947;700;2021-12-27;-51719
2021-12-26;"Košický kraj";109;2510;115;2625;NA;110947;224;2021-12-26;-52419
2021-12-25;"Košický kraj";30;644;43;687;NA;110947;73;2021-12-25;-52643
2021-12-24;"Košický kraj";95;1055;50;1105;NA;110947;145;2021-12-24;-52716
2021-12-23;"Košický kraj";644;4479;131;4610;NA;110947;775;2021-12-23;-52861
2021-12-22;"Košický kraj";224;4309;106;4415;NA;110947;330;2021-12-22;-53636
2021-12-21;"Košický kraj";544;6491;138;6629;NA;110947;682;2021-12-21;-53966
2021-12-20;"Košický kraj";464;8630;196;8826;NA;110947;660;2021-12-20;-54648
2021-12-19;"Košický kraj";137;5447;177;5624;NA;110947;314;2021-12-19;-55308
2021-12-18;"Košický kraj";414;2555;102;2657;NA;110947;516;2021-12-18;-55622
2021-12-17;"Košický kraj";428;4832;145;4977;NA;110947;573;2021-12-17;-56138
2021-12-16;"Košický kraj";476;5845;168;6013;NA;110947;644;2021-12-16;-56711
2021-12-15;"Košický kraj";508;5956;172;6128;NA;110947;680;2021-12-15;-57355
2021-12-14;"Košický kraj";957;5789;172;5961;NA;110947;1129;2021-12-14;-58035
2021-12-13;"Košický kraj";679;9657;248;9905;NA;110947;927;2021-12-13;-59164
2021-12-12;"Košický kraj";243;6657;198;6855;NA;110947;441;2021-12-12;-60091
2021-12-11;"Košický kraj";519;2996;134;3130;NA;110947;653;2021-12-11;-60532
2021-12-10;"Košický kraj";936;5465;185;5650;NA;110947;1121;2021-12-10;-61185
2021-12-09;"Košický kraj";755;5779;198;5977;NA;110947;953;2021-12-09;-62306
2021-12-08;"Košický kraj";1095;6574;275;6849;NA;110947;1370;2021-12-08;-63259
2021-12-07;"Košický kraj";1212;6323;267;6590;NA;110947;1479;2021-12-07;-64629
2021-12-06;"Košický kraj";904;10627;313;10940;NA;110947;1217;2021-12-06;-66108
2021-12-05;"Košický kraj";404;7756;263;8019;NA;110947;667;2021-12-05;-67325
2021-12-04;"Košický kraj";1007;3097;180;3277;NA;110947;1187;2021-12-04;-67992
2021-12-03;"Košický kraj";1338;6065;271;6336;NA;110947;1609;2021-12-03;-69179
2021-12-02;"Košický kraj";2209;5654;302;5956;NA;110947;2511;2021-12-02;-70788
2021-12-01;"Košický kraj";1016;6483;388;6871;NA;110947;1404;2021-12-01;-73299
2021-11-30;"Košický kraj";1125;8173;471;8644;NA;110947;1596;2021-11-30;-74703
2021-11-29;"Košický kraj";993;14057;634;14691;NA;110947;1627;2021-11-29;-76299
2021-11-28;"Košický kraj";972;10211;473;10684;NA;110947;1445;2021-11-28;-77926
2021-11-27;"Košický kraj";1103;3566;219;3785;NA;110947;1322;2021-11-27;-79371
2021-11-26;"Košický kraj";1395;6059;383;6442;NA;110947;1778;2021-11-26;-80693
2021-11-25;"Košický kraj";1373;7016;499;7515;NA;110947;1872;2021-11-25;-82471
2021-11-24;"Košický kraj";1194;7067;473;7540;NA;110947;1667;2021-11-24;-84343
2021-11-23;"Košický kraj";1178;7185;488;7673;NA;110947;1666;2021-11-23;-86010
2021-11-22;"Košický kraj";861;10709;741;11450;NA;110947;1602;2021-11-22;-87676
2021-11-21;"Košický kraj";985;7394;657;8051;NA;110947;1642;2021-11-21;-89278
2021-11-20;"Košický kraj";1083;2859;295;3154;NA;110947;1378;2021-11-20;-90920
2021-11-19;"Košický kraj";1078;7543;516;8059;NA;110947;1594;2021-11-19;-92298
2021-11-18;"Košický kraj";1061;9410;719;10129;NA;110947;1780;2021-11-18;-93892
2021-11-17;"Košický kraj";1319;2824;262;3086;NA;110947;1581;2021-11-17;-95672
2021-11-16;"Košický kraj";1484;7135;543;7678;NA;110947;2027;2021-11-16;-97253
2021-11-15;"Košický kraj";902;10812;754;11566;NA;110947;1656;2021-11-15;-99280
2021-11-14;"Košický kraj";715;5756;455;6211;NA;110947;1170;2021-11-14;-100936
2021-11-13;"Košický kraj";869;2686;312;2998;NA;110947;1181;2021-11-13;-102106
2021-11-12;"Košický kraj";1132;5616;410;6026;NA;110947;1542;2021-11-12;-103287
2021-11-11;"Košický kraj";1035;6139;460;6599;NA;110947;1495;2021-11-11;-104829
2021-11-10;"Košický kraj";933;6633;497;7130;NA;110947;1430;2021-11-10;-106324
2021-11-09;"Košický kraj";967;5540;389;5929;NA;110947;1356;2021-11-09;-107754
2021-11-08;"Košický kraj";701;7838;601;8439;NA;110947;1302;2021-11-08;-109110
2021-11-07;"Košický kraj";691;4578;425;5003;NA;110947;1116;2021-11-07;-110412
2021-11-06;"Košický kraj";996;2276;217;2493;NA;110947;1213;2021-11-06;-111528
2021-11-05;"Košický kraj";1029;4905;367;5272;NA;110947;1396;2021-11-05;-112741
2021-11-04;"Košický kraj";1000;5354;360;5714;NA;110947;1360;2021-11-04;-114137
2021-11-03;"Košický kraj";1051;5749;361;6110;NA;110947;1412;2021-11-03;-115497
2021-11-02;"Košický kraj";915;8775;566;9341;NA;110947;1481;2021-11-02;-116909
2021-11-01;"Košický kraj";181;1999;265;2264;NA;110947;446;2021-11-01;-118390
2021-10-31;"Košický kraj";385;2337;227;2564;NA;110947;612;2021-10-31;-118836
2021-10-30;"Košický kraj";641;2380;180;2560;NA;110947;821;2021-10-30;-119448
2021-10-29;"Košický kraj";750;4608;289;4897;NA;110947;1039;2021-10-29;-120269
2021-10-28;"Košický kraj";823;5115;255;5370;NA;110947;1078;2021-10-28;-121308
2021-10-27;"Košický kraj";723;4831;259;5090;NA;110947;982;2021-10-27;-122386
2021-10-26;"Košický kraj";618;5049;225;5274;NA;110947;843;2021-10-26;-123368
2021-10-25;"Košický kraj";268;6747;292;7039;NA;110947;560;2021-10-25;-124211
2021-10-24;"Košický kraj";170;3447;205;3652;NA;110947;375;2021-10-24;-124771
2021-10-23;"Košický kraj";397;1953;86;2039;NA;110947;483;2021-10-23;-125146
2021-10-22;"Košický kraj";474;4679;130;4809;NA;110947;604;2021-10-22;-125629
2021-10-21;"Košický kraj";669;5094;172;5266;NA;110947;841;2021-10-21;-126233
2021-10-20;"Košický kraj";398;4963;152;5115;NA;110947;550;2021-10-20;-127074
2021-10-19;"Košický kraj";579;4870;161;5031;NA;110947;740;2021-10-19;-127624
2021-10-18;"Košický kraj";180;7090;171;7261;NA;110947;351;2021-10-18;-128364
2021-10-17;"Košický kraj";70;3614;125;3739;NA;110947;195;2021-10-17;-128715
2021-10-16;"Košický kraj";312;1839;40;1879;NA;110947;352;2021-10-16;-128910
2021-10-15;"Košický kraj";312;4530;77;4607;NA;110947;389;2021-10-15;-129262
2021-10-14;"Košický kraj";327;4652;95;4747;NA;110947;422;2021-10-14;-129651
2021-10-13;"Košický kraj";168;4168;88;4256;NA;110947;256;2021-10-13;-130073
2021-10-12;"Košický kraj";391;4119;75;4194;NA;110947;466;2021-10-12;-130329
2021-10-11;"Košický kraj";119;6351;121;6472;NA;110947;240;2021-10-11;-130795
2021-10-10;"Košický kraj";104;2921;63;2984;NA;110947;167;2021-10-10;-131035
2021-10-09;"Košický kraj";111;1687;43;1730;NA;110947;154;2021-10-09;-131202
2021-10-08;"Košický kraj";274;4143;68;4211;NA;110947;342;2021-10-08;-131356
2021-10-07;"Košický kraj";277;4399;74;4473;NA;110947;351;2021-10-07;-131698
2021-10-06;"Košický kraj";178;4369;89;4458;NA;110947;267;2021-10-06;-132049
2021-10-05;"Košický kraj";345;4542;78;4620;NA;110947;423;2021-10-05;-132316
2021-10-04;"Košický kraj";122;6094;110;6204;NA;110947;232;2021-10-04;-132739
2021-10-03;"Košický kraj";133;3176;74;3250;NA;110947;207;2021-10-03;-132971
2021-10-02;"Košický kraj";124;2567;41;2608;NA;110947;165;2021-10-02;-133178
2021-10-01;"Košický kraj";181;4251;73;4324;NA;110947;254;2021-10-01;-133343
2021-09-30;"Košický kraj";244;4780;71;4851;NA;110947;315;2021-09-30;-133597
2021-09-29;"Košický kraj";183;3824;64;3888;NA;110947;247;2021-09-29;-133912
2021-09-28;"Košický kraj";303;4339;80;4419;NA;110947;383;2021-09-28;-134159
2021-09-27;"Košický kraj";117;6358;77;6435;NA;110947;194;2021-09-27;-134542
2021-09-26;"Košický kraj";13;2809;44;2853;NA;110947;57;2021-09-26;-134736
2021-09-25;"Košický kraj";162;2521;35;2556;NA;110947;197;2021-09-25;-134793
2021-09-24;"Košický kraj";183;4756;43;4799;NA;110947;226;2021-09-24;-134990
2021-09-23;"Košický kraj";142;3880;51;3931;NA;110947;193;2021-09-23;-135216
2021-09-22;"Košický kraj";151;4436;52;4488;NA;110947;203;2021-09-22;-135409
2021-09-21;"Košický kraj";234;4441;44;4485;NA;110947;278;2021-09-21;-135612
2021-09-20;"Košický kraj";158;6017;73;6090;NA;110947;231;2021-09-20;-135890
2021-09-19;"Košický kraj";15;2487;30;2517;NA;110947;45;2021-09-19;-136121
2021-09-18;"Košický kraj";187;2504;24;2528;NA;110947;211;2021-09-18;-136166
2021-09-17;"Košický kraj";121;4797;41;4838;NA;110947;162;2021-09-17;-136377
2021-09-16;"Košický kraj";228;4503;71;4574;NA;110947;299;2021-09-16;-136539
2021-09-15;"Košický kraj";52;989;16;1005;NA;110947;68;2021-09-15;-136838
2021-09-14;"Košický kraj";142;3456;47;3503;NA;110947;189;2021-09-14;-136906
2021-09-13;"Košický kraj";96;4949;48;4997;NA;110947;144;2021-09-13;-137095
2021-09-12;"Košický kraj";14;2003;31;2034;NA;110947;45;2021-09-12;-137239
2021-09-11;"Košický kraj";105;2186;19;2205;NA;110947;124;2021-09-11;-137284
2021-09-10;"Košický kraj";125;4293;42;4335;NA;110947;167;2021-09-10;-137408
2021-09-09;"Košický kraj";115;3226;30;3256;NA;110947;145;2021-09-09;-137575
2021-09-08;"Košický kraj";86;2753;36;2789;NA;110947;122;2021-09-08;-137720
2021-09-07;"Košický kraj";79;2686;53;2739;NA;110947;132;2021-09-07;-137842
2021-09-06;"Košický kraj";41;2786;36;2822;NA;110947;77;2021-09-06;-137974
2021-09-05;"Košický kraj";52;1393;18;1411;NA;110947;70;2021-09-05;-138051
2021-09-04;"Košický kraj";37;1678;12;1690;NA;110947;49;2021-09-04;-138121
2021-09-03;"Košický kraj";47;2913;35;2948;NA;110947;82;2021-09-03;-138170
2021-09-02;"Košický kraj";56;2686;26;2712;NA;110947;82;2021-09-02;-138252
2021-09-01;"Košický kraj";95;629;13;642;NA;110947;108;2021-09-01;-138334
2021-08-31;"Košický kraj";30;2525;22;2547;NA;110947;52;2021-08-31;-138442
2021-08-30;"Košický kraj";8;2404;28;2432;NA;110947;36;2021-08-30;-138494
2021-08-29;"Košický kraj";16;603;1;604;NA;110947;17;2021-08-29;-138530
2021-08-28;"Košický kraj";14;2103;11;2114;NA;110947;25;2021-08-28;-138547
2021-08-27;"Košický kraj";22;2908;16;2924;NA;110947;38;2021-08-27;-138572
2021-08-26;"Košický kraj";19;2292;13;2305;NA;110947;32;2021-08-26;-138610
2021-08-25;"Košický kraj";33;2010;6;2016;NA;110947;39;2021-08-25;-138642
2021-08-24;"Košický kraj";14;2337;3;2340;NA;110947;17;2021-08-24;-138681
2021-08-23;"Košický kraj";33;2461;5;2466;NA;110947;38;2021-08-23;-138698
2021-08-22;"Košický kraj";4;1457;8;1465;NA;110947;12;2021-08-22;-138736
2021-08-21;"Košický kraj";35;2134;5;2139;NA;110947;40;2021-08-21;-138748
2021-08-20;"Košický kraj";13;3215;5;3220;NA;110947;18;2021-08-20;-138788
2021-08-19;"Košický kraj";14;2178;6;2184;NA;110947;20;2021-08-19;-138806
2021-08-18;"Košický kraj";30;1827;8;1835;NA;110947;38;2021-08-18;-138826
2021-08-17;"Košický kraj";24;1619;3;1622;NA;110947;27;2021-08-17;-138864
2021-08-16;"Košický kraj";3;2236;10;2246;NA;110947;13;2021-08-16;-138891
2021-08-15;"Košický kraj";1;778;5;783;NA;110947;6;2021-08-15;-138904
2021-08-14;"Košický kraj";15;1222;1;1223;NA;110947;16;2021-08-14;-138910
2021-08-13;"Košický kraj";14;1928;8;1936;NA;110947;22;2021-08-13;-138926
2021-08-12;"Košický kraj";10;1248;3;1251;NA;110947;13;2021-08-12;-138948
2021-08-11;"Košický kraj";6;1368;5;1373;NA;110947;11;2021-08-11;-138961
2021-08-10;"Košický kraj";10;1352;8;1360;NA;110947;18;2021-08-10;-138972
2021-08-09;"Košický kraj";12;1651;3;1654;NA;110947;15;2021-08-09;-138990
2021-08-08;"Košický kraj";8;688;1;689;NA;110947;9;2021-08-08;-139005
2021-08-07;"Košický kraj";3;1125;3;1128;NA;110947;6;2021-08-07;-139014
2021-08-06;"Košický kraj";9;1614;6;1620;NA;110947;15;2021-08-06;-139020
2021-08-05;"Košický kraj";26;1254;6;1260;NA;110947;32;2021-08-05;-139035
2021-08-04;"Košický kraj";8;1373;5;1378;NA;110947;13;2021-08-04;-139067
2021-08-03;"Košický kraj";33;1121;3;1124;NA;110947;36;2021-08-03;-139080
2021-08-02;"Košický kraj";6;1702;8;1710;NA;110947;14;2021-08-02;-139116
2021-08-01;"Košický kraj";1;662;1;663;NA;110947;2;2021-08-01;-139130
2021-07-31;"Košický kraj";17;1153;2;1155;NA;110947;19;2021-07-31;-139132
2021-07-30;"Košický kraj";12;1657;7;1664;NA;110947;19;2021-07-30;-139151
2021-07-29;"Košický kraj";7;1242;5;1247;NA;110947;12;2021-07-29;-139170
2021-07-28;"Košický kraj";15;956;5;961;NA;110947;20;2021-07-28;-139182
2021-07-27;"Košický kraj";17;1180;7;1187;NA;110947;24;2021-07-27;-139202
2021-07-26;"Košický kraj";3;1666;9;1675;NA;110947;12;2021-07-26;-139226
2021-07-25;"Košický kraj";0;719;3;722;NA;110947;3;2021-07-25;-139238
2021-07-24;"Košický kraj";18;996;4;1000;NA;110947;22;2021-07-24;-139241
2021-07-23;"Košický kraj";9;1524;5;1529;NA;110947;14;2021-07-23;-139263
2021-07-22;"Košický kraj";1;1254;4;1258;NA;110947;5;2021-07-22;-139277
2021-07-21;"Košický kraj";4;1117;3;1120;NA;110947;7;2021-07-21;-139282
2021-07-20;"Košický kraj";6;1355;1;1356;NA;110947;7;2021-07-20;-139289
2021-07-19;"Košický kraj";2;1517;2;1519;NA;110947;4;2021-07-19;-139296
2021-07-18;"Košický kraj";0;644;0;644;NA;110947;0;2021-07-18;-139300
2021-07-17;"Košický kraj";3;1101;5;1106;NA;110947;8;2021-07-17;-139300
2021-07-16;"Košický kraj";3;1609;4;1613;NA;110947;7;2021-07-16;-139308
2021-07-15;"Košický kraj";4;1383;4;1387;NA;110947;8;2021-07-15;-139315
2021-07-14;"Košický kraj";2;1175;4;1179;NA;110947;6;2021-07-14;-139323
2021-07-13;"Košický kraj";4;1331;1;1332;NA;110947;5;2021-07-13;-139329
2021-07-12;"Košický kraj";3;1894;3;1897;NA;110947;6;2021-07-12;-139334
2021-07-11;"Košický kraj";1;537;2;539;NA;110947;3;2021-07-11;-139340
2021-07-10;"Košický kraj";9;1167;0;1167;NA;110947;9;2021-07-10;-139343
2021-07-09;"Košický kraj";5;2005;5;2010;NA;110947;10;2021-07-09;-139352
2021-07-08;"Košický kraj";13;1282;2;1284;NA;110947;15;2021-07-08;-139362
2021-07-07;"Košický kraj";6;1524;1;1525;NA;110947;7;2021-07-07;-139377
2021-07-06;"Košický kraj";4;1886;2;1888;NA;110947;6;2021-07-06;-139384
2021-07-05;"Košický kraj";1;573;1;574;NA;110947;2;2021-07-05;-139390
2021-07-04;"Košický kraj";0;482;2;484;NA;110947;2;2021-07-04;-139392
2021-07-03;"Košický kraj";2;1227;0;1227;NA;110947;2;2021-07-03;-139394
2021-07-02;"Košický kraj";2;1883;3;1886;NA;110947;5;2021-07-02;-139396
2021-07-01;"Košický kraj";0;1211;2;1213;NA;110947;2;2021-07-01;-139401
2021-06-30;"Košický kraj";5;9306;7;9313;NA;110947;12;2021-06-30;-139403
2021-06-29;"Košický kraj";6;5692;7;5699;NA;110947;13;2021-06-29;-139415
2021-06-28;"Košický kraj";5;6129;2;6131;NA;110947;7;2021-06-28;-139428
2021-06-27;"Košický kraj";8;4636;3;4639;NA;110947;11;2021-06-27;-139435
2021-06-26;"Košický kraj";4;5699;14;5713;NA;110947;18;2021-06-26;-139446
2021-06-25;"Košický kraj";5;6981;2;6983;NA;110947;7;2021-06-25;-139464
2021-06-24;"Košický kraj";1;5072;3;5075;NA;110947;4;2021-06-24;-139471
2021-06-23;"Košický kraj";8;5373;3;5376;NA;110947;11;2021-06-23;-139475
2021-06-22;"Košický kraj";1;5269;3;5272;NA;110947;4;2021-06-22;-139486
2021-06-21;"Košický kraj";5;6830;11;6841;NA;110947;16;2021-06-21;-139490
2021-06-20;"Košický kraj";0;4882;6;4888;NA;110947;6;2021-06-20;-139506
2021-06-19;"Košický kraj";7;6473;1;6474;NA;110947;8;2021-06-19;-139512
2021-06-18;"Košický kraj";4;7969;8;7977;NA;110947;12;2021-06-18;-139520
2021-06-17;"Košický kraj";6;6128;3;6131;NA;110947;9;2021-06-17;-139532
2021-06-16;"Košický kraj";11;6059;7;6066;NA;110947;18;2021-06-16;-139541
2021-06-15;"Košický kraj";12;6301;2;6303;NA;110947;14;2021-06-15;-139559
2021-06-14;"Košický kraj";10;7076;9;7085;NA;110947;19;2021-06-14;-139573
2021-06-13;"Košický kraj";7;6948;8;6956;NA;110947;15;2021-06-13;-139592
2021-06-12;"Košický kraj";7;7485;9;7494;NA;110947;16;2021-06-12;-139607
2021-06-11;"Košický kraj";15;8973;6;8979;NA;110947;21;2021-06-11;-139623
2021-06-10;"Košický kraj";11;6588;16;6604;NA;110947;27;2021-06-10;-139644
2021-06-09;"Košický kraj";37;6056;7;6063;NA;110947;44;2021-06-09;-139671
2021-06-08;"Košický kraj";33;7019;13;7032;NA;110947;46;2021-06-08;-139715
2021-06-07;"Košický kraj";11;8106;22;8128;NA;110947;33;2021-06-07;-139761
2021-06-06;"Košický kraj";1;7843;7;7850;NA;110947;8;2021-06-06;-139794
2021-06-05;"Košický kraj";21;9286;3;9289;NA;110947;24;2021-06-05;-139802
2021-06-04;"Košický kraj";26;11418;20;11438;NA;110947;46;2021-06-04;-139826
2021-06-03;"Košický kraj";23;6467;14;6481;NA;110947;37;2021-06-03;-139872
2021-06-02;"Košický kraj";15;7180;24;7204;NA;110947;39;2021-06-02;-139909
2021-06-01;"Košický kraj";13;7562;10;7572;NA;110947;23;2021-06-01;-139948
2021-05-31;"Košický kraj";13;9256;18;9274;NA;110947;31;2021-05-31;-139971
2021-05-30;"Košický kraj";3;11215;10;11225;NA;110947;13;2021-05-30;-140002
2021-05-29;"Košický kraj";25;10942;22;10964;NA;110947;47;2021-05-29;-140015
2021-05-28;"Košický kraj";17;13055;29;13084;NA;110947;46;2021-05-28;-140062
2021-05-27;"Košický kraj";19;7924;26;7950;NA;110947;45;2021-05-27;-140108
2021-05-26;"Košický kraj";35;8118;27;8145;NA;110947;62;2021-05-26;-140153
2021-05-25;"Košický kraj";33;9296;29;9325;NA;110947;62;2021-05-25;-140215
2021-05-24;"Košický kraj";10;10855;27;10882;NA;110947;37;2021-05-24;-140277
2021-05-23;"Košický kraj";4;12151;15;12166;NA;110947;19;2021-05-23;-140314
2021-05-22;"Košický kraj";27;12601;19;12620;NA;110947;46;2021-05-22;-140333
2021-05-21;"Košický kraj";24;14910;27;14937;NA;110947;51;2021-05-21;-140379
2021-05-20;"Košický kraj";20;9422;28;9450;NA;110947;48;2021-05-20;-140430
2021-05-19;"Košický kraj";30;10421;21;10442;NA;110947;51;2021-05-19;-140478
2021-05-18;"Košický kraj";34;10254;36;10290;NA;110947;70;2021-05-18;-140529
2021-05-17;"Košický kraj";20;12686;38;12724;NA;110947;58;2021-05-17;-140599
2021-05-16;"Košický kraj";37;17865;20;17885;NA;110947;57;2021-05-16;-140657
2021-05-15;"Košický kraj";22;25602;28;25630;NA;110947;50;2021-05-15;-140714
2021-05-14;"Košický kraj";32;21824;42;21866;NA;110947;74;2021-05-14;-140764
2021-05-13;"Košický kraj";39;10172;32;10204;NA;110947;71;2021-05-13;-140838
2021-05-12;"Košický kraj";85;10868;33;10901;NA;110947;118;2021-05-12;-140909
2021-05-11;"Košický kraj";68;11166;32;11198;NA;110947;100;2021-05-11;-141027
2021-05-10;"Košický kraj";25;17044;42;17086;NA;110947;67;2021-05-10;-141127
2021-05-09;"Košický kraj";84;25594;55;25649;NA;110947;139;2021-05-09;-141194
2021-05-08;"Košický kraj";18;23399;23;23422;NA;110947;41;2021-05-08;-141333
2021-05-07;"Košický kraj";51;24497;57;24554;NA;110947;108;2021-05-07;-141374
2021-05-06;"Košický kraj";55;11847;43;11890;NA;110947;98;2021-05-06;-141482
2021-05-05;"Košický kraj";23;12124;35;12159;NA;110947;58;2021-05-05;-141580
2021-05-04;"Košický kraj";143;13562;38;13600;NA;110947;181;2021-05-04;-141638
2021-05-03;"Košický kraj";37;16944;68;17012;NA;110947;105;2021-05-03;-141819
2021-05-02;"Košický kraj";45;36096;56;36152;NA;110947;101;2021-05-02;-141924
2021-05-01;"Košický kraj";54;52075;76;52151;NA;110947;130;2021-05-01;-142025
2021-04-30;"Košický kraj";59;44602;94;44696;NA;110947;153;2021-04-30;-142155
2021-04-29;"Košický kraj";76;17014;53;17067;NA;110947;129;2021-04-29;-142308
2021-04-28;"Košický kraj";99;17970;52;18022;NA;110947;151;2021-04-28;-142437
2021-04-27;"Košický kraj";108;20670;43;20713;NA;110947;151;2021-04-27;-142588
2021-04-26;"Košický kraj";39;25915;96;26011;NA;110947;135;2021-04-26;-142739
2021-04-25;"Košický kraj";23;48355;57;48412;NA;110947;80;2021-04-25;-142874
2021-04-24;"Košický kraj";68;90124;114;90238;NA;110947;182;2021-04-24;-142954
2021-04-23;"Košický kraj";110;41232;72;41304;NA;110947;182;2021-04-23;-143136
2021-04-22;"Košický kraj";56;16772;44;16816;NA;110947;100;2021-04-22;-143318
2021-04-21;"Košický kraj";114;19519;61;19580;NA;110947;175;2021-04-21;-143418
2021-04-20;"Košický kraj";81;25432;63;25495;NA;110947;144;2021-04-20;-143593
2021-04-19;"Košický kraj";93;29950;108;30058;NA;110947;201;2021-04-19;-143737
2021-04-18;"Košický kraj";10;48913;82;48995;NA;110947;92;2021-04-18;-143938
2021-04-17;"Košický kraj";187;83856;103;83959;NA;110947;290;2021-04-17;-144030
2021-04-16;"Košický kraj";83;41568;127;41695;NA;110947;210;2021-04-16;-144320
2021-04-15;"Košický kraj";104;18522;93;18615;NA;110947;197;2021-04-15;-144530
2021-04-14;"Košický kraj";119;20089;64;20153;NA;110947;183;2021-04-14;-144727
2021-04-13;"Košický kraj";81;23175;120;23295;NA;110947;201;2021-04-13;-144910
2021-04-12;"Košický kraj";129;26573;124;26697;NA;110947;253;2021-04-12;-145111
2021-04-11;"Košický kraj";29;46949;80;47029;NA;110947;109;2021-04-11;-145364
2021-04-10;"Košický kraj";138;100114;183;100297;NA;110947;321;2021-04-10;-145473
2021-04-09;"Košický kraj";168;35206;133;35339;NA;110947;301;2021-04-09;-145794
2021-04-08;"Košický kraj";81;18530;90;18620;NA;110947;171;2021-04-08;-146095
2021-04-07;"Košický kraj";232;28027;194;28221;NA;110947;426;2021-04-07;-146266
2021-04-06;"Košický kraj";121;36495;164;36659;NA;110947;285;2021-04-06;-146692
2021-04-05;"Košický kraj";19;14361;66;14427;NA;110947;85;2021-04-05;-146977
2021-04-04;"Košický kraj";33;15089;66;15155;NA;110947;99;2021-04-04;-147062
2021-04-03;"Košický kraj";138;97664;241;97905;NA;110947;379;2021-04-03;-147161
2021-04-02;"Košický kraj";128;24515;76;24591;NA;110947;204;2021-04-02;-147540
2021-04-01;"Košický kraj";165;46151;156;46307;NA;110947;321;2021-04-01;-147744
2021-03-31;"Košický kraj";160;29659;124;29783;NA;110947;284;2021-03-31;-148065
2021-03-30;"Košický kraj";229;24038;163;24201;NA;110947;392;2021-03-30;-148349
2021-03-29;"Košický kraj";78;28843;194;29037;NA;110947;272;2021-03-29;-148741
2021-03-28;"Košický kraj";39;44263;128;44391;NA;110947;167;2021-03-28;-149013
2021-03-27;"Košický kraj";222;96602;265;96867;NA;110947;487;2021-03-27;-149180
2021-03-26;"Košický kraj";233;45252;202;45454;NA;110947;435;2021-03-26;-149667
2021-03-25;"Košický kraj";133;23804;175;23979;NA;110947;308;2021-03-25;-150102
2021-03-24;"Košický kraj";165;20696;155;20851;NA;110947;320;2021-03-24;-150410
2021-03-23;"Košický kraj";202;22434;192;22626;NA;110947;394;2021-03-23;-150730
2021-03-22;"Košický kraj";169;26890;228;27118;NA;110947;397;2021-03-22;-151124
2021-03-21;"Košický kraj";109;46746;167;46913;NA;110947;276;2021-03-21;-151521
2021-03-20;"Košický kraj";126;101334;311;101645;NA;110947;437;2021-03-20;-151797
2021-03-19;"Košický kraj";205;45632;260;45892;NA;110947;465;2021-03-19;-152234
2021-03-18;"Košický kraj";274;23827;212;24039;NA;110947;486;2021-03-18;-152699
2021-03-17;"Košický kraj";177;21548;195;21743;NA;110947;372;2021-03-17;-153185
2021-03-16;"Košický kraj";386;23454;226;23680;NA;110947;612;2021-03-16;-153557
2021-03-15;"Košický kraj";173;27900;297;28197;NA;110947;470;2021-03-15;-154169
2021-03-14;"Košický kraj";145;44354;220;44574;NA;110947;365;2021-03-14;-154639
2021-03-13;"Košický kraj";146;103790;483;104273;NA;110947;629;2021-03-13;-155004
2021-03-12;"Košický kraj";366;47871;321;48192;NA;110947;687;2021-03-12;-155633
2021-03-11;"Košický kraj";396;23229;263;23492;NA;110947;659;2021-03-11;-156320
2021-03-10;"Košický kraj";121;22205;269;22474;NA;110947;390;2021-03-10;-156979
2021-03-09;"Košický kraj";676;24509;300;24809;NA;110947;976;2021-03-09;-157369
2021-03-08;"Košický kraj";559;29852;344;30196;NA;110947;903;2021-03-08;-158345
2021-03-07;"Košický kraj";45;44230;299;44529;NA;110947;344;2021-03-07;-159248
2021-03-06;"Košický kraj";177;105598;532;106130;NA;110947;709;2021-03-06;-159592
2021-03-05;"Košický kraj";439;45567;424;45991;NA;110947;863;2021-03-05;-160301
2021-03-04;"Košický kraj";417;23862;320;24182;NA;110947;737;2021-03-04;-161164
2021-03-03;"Košický kraj";390;23169;298;23467;NA;110947;688;2021-03-03;-161901
2021-03-02;"Košický kraj";464;24158;368;24526;NA;110947;832;2021-03-02;-162589
2021-03-01;"Košický kraj";389;30013;514;30527;NA;110947;903;2021-03-01;-163421
2021-02-28;"Košický kraj";265;43053;334;43387;NA;110947;599;2021-02-28;-164324
2021-02-27;"Košický kraj";301;100559;784;101343;NA;110947;1085;2021-02-27;-164923
2021-02-26;"Košický kraj";440;45466;492;45958;NA;110947;932;2021-02-26;-166008
2021-02-25;"Košický kraj";331;19872;342;20214;NA;110947;673;2021-02-25;-166940
2021-02-24;"Košický kraj";263;18751;505;19256;NA;110947;768;2021-02-24;-167613
2021-02-23;"Košický kraj";642;21605;341;21946;NA;110947;983;2021-02-23;-168381
2021-02-22;"Košický kraj";362;30858;434;31292;NA;110947;796;2021-02-22;-169364
2021-02-21;"Košický kraj";170;40464;385;40849;NA;110947;555;2021-02-21;-170160
2021-02-20;"Košický kraj";283;92550;770;93320;NA;110947;1053;2021-02-20;-170715
2021-02-19;"Košický kraj";507;41579;583;42162;NA;110947;1090;2021-02-19;-171768
2021-02-18;"Košický kraj";397;18442;345;18787;NA;110947;742;2021-02-18;-172858
2021-02-17;"Košický kraj";322;18080;387;18467;NA;110947;709;2021-02-17;-173600
2021-02-16;"Košický kraj";600;22111;463;22574;NA;110947;1063;2021-02-16;-174309
2021-02-15;"Košický kraj";216;27633;419;28052;NA;110947;635;2021-02-15;-175372
2021-02-14;"Košický kraj";241;56743;524;57267;NA;110947;765;2021-02-14;-176007
2021-02-13;"Košický kraj";206;93745;765;94510;NA;110947;971;2021-02-13;-176772
2021-02-12;"Košický kraj";448;49924;611;50535;NA;110947;1059;2021-02-12;-177743
2021-02-11;"Košický kraj";435;14524;323;14847;NA;110947;758;2021-02-11;-178802
2021-02-10;"Košický kraj";360;18475;431;18906;NA;110947;791;2021-02-10;-179560
2021-02-09;"Košický kraj";544;24841;463;25304;NA;110947;1007;2021-02-09;-180351
2021-02-08;"Košický kraj";237;24836;392;25228;NA;110947;629;2021-02-08;-181358
2021-02-07;"Košický kraj";208;56897;612;57509;NA;110947;820;2021-02-07;-181987
2021-02-06;"Košický kraj";318;104357;884;105241;NA;110947;1202;2021-02-06;-182807
2021-02-05;"Košický kraj";384;43186;494;43680;NA;110947;878;2021-02-05;-184009
2021-02-04;"Košický kraj";391;14512;371;14883;NA;110947;762;2021-02-04;-184887
2021-02-03;"Košický kraj";296;12599;339;12938;NA;110947;635;2021-02-03;-185649
2021-02-02;"Košický kraj";473;43883;1212;45095;NA;110947;1685;2021-02-02;-186284
2021-02-01;"Košický kraj";415;21984;362;22346;NA;110947;777;2021-02-01;-187969
2021-01-31;"Košický kraj";142;54690;617;55307;NA;110947;759;2021-01-31;-188746
2021-01-30;"Košický kraj";320;76722;661;77383;NA;110947;981;2021-01-30;-189505
2021-01-29;"Košický kraj";311;37164;466;37630;NA;110947;777;2021-01-29;-190486
2021-01-28;"Košický kraj";540;9006;244;9250;NA;110947;784;2021-01-28;-191263
2021-01-27;"Košický kraj";265;7575;211;7786;NA;110947;476;2021-01-27;-192047
2021-01-26;"Košický kraj";530;14210;245;14455;NA;110947;775;2021-01-26;-192523
2021-01-25;"Košický kraj";226;26431;413;26844;NA;110947;639;2021-01-25;-193298
2021-01-24;"Košický kraj";150;44419;581;45000;NA;110947;731;2021-01-24;-193937
2021-01-23;"Košický kraj";232;82705;857;83562;NA;110947;1089;2021-01-23;-194668
2021-01-22;"Košický kraj";316;19997;265;20262;NA;110947;581;2021-01-22;-195757
2021-01-21;"Košický kraj";274;14053;159;14212;NA;110947;433;2021-01-21;-196338
2021-01-20;"Košický kraj";374;10844;201;11045;NA;110947;575;2021-01-20;-196771
2021-01-19;"Košický kraj";248;9717;181;9898;NA;110947;429;2021-01-19;-197346
2021-01-18;"Košický kraj";333;7659;262;7921;NA;110947;595;2021-01-18;-197775
2021-01-17;"Košický kraj";155;535;14;549;NA;110947;169;2021-01-17;-198370
2021-01-16;"Košický kraj";153;1403;47;1450;NA;110947;200;2021-01-16;-198539
2021-01-15;"Košický kraj";308;6443;213;6656;NA;110947;521;2021-01-15;-198739
2021-01-14;"Košický kraj";358;5471;221;5692;NA;110947;579;2021-01-14;-199260
2021-01-13;"Košický kraj";421;4897;226;5123;NA;110947;647;2021-01-13;-199839
2021-01-12;"Košický kraj";482;6473;237;6710;NA;110947;719;2021-01-12;-200486
2021-01-11;"Košický kraj";309;7553;286;7839;NA;110947;595;2021-01-11;-201205
2021-01-10;"Košický kraj";193;136;6;142;NA;110947;199;2021-01-10;-201800
2021-01-09;"Košický kraj";469;1134;45;1179;NA;110947;514;2021-01-09;-201999
2021-01-08;"Košický kraj";551;7106;348;7454;NA;110947;899;2021-01-08;-202513
2021-01-07;"Košický kraj";251;5853;398;6251;NA;110947;649;2021-01-07;-203412
2021-01-06;"Košický kraj";442;429;33;462;NA;110947;475;2021-01-06;-204061
2021-01-05;"Košický kraj";584;7633;527;8160;NA;110947;1111;2021-01-05;-204536
2021-01-04;"Košický kraj";407;6479;660;7139;NA;110947;1067;2021-01-04;-205647
2021-01-03;"Košický kraj";118;661;22;683;NA;110947;140;2021-01-03;-206714
2021-01-02;"Košický kraj";88;440;52;492;NA;110947;140;2021-01-02;-206854
2021-01-01;"Košický kraj";398;725;49;774;NA;110947;447;2021-01-01;-206994
2020-12-31;"Košický kraj";625;7509;453;7962;NA;110947;1078;2020-12-31;-207441
2020-12-30;"Košický kraj";590;6076;395;6471;NA;110947;985;2020-12-30;-208519
2020-12-29;"Košický kraj";419;7454;596;8050;NA;110947;1015;2020-12-29;-209504
2020-12-28;"Košický kraj";356;7933;756;8689;NA;110947;1112;2020-12-28;-210519
2020-12-27;"Košický kraj";159;147;16;163;NA;110947;175;2020-12-27;-211631
2020-12-26;"Košický kraj";163;274;23;297;NA;110947;186;2020-12-26;-211806
2020-12-25;"Košický kraj";237;140;10;150;NA;110947;247;2020-12-25;-211992
2020-12-24;"Košický kraj";564;1470;90;1560;NA;110947;654;2020-12-24;-212239
2020-12-23;"Košický kraj";304;7339;327;7666;NA;110947;631;2020-12-23;-212893
2020-12-22;"Košický kraj";438;7284;429;7713;NA;110947;867;2020-12-22;-213524
2020-12-21;"Košický kraj";405;6703;504;7207;NA;110947;909;2020-12-21;-214391
2020-12-20;"Košický kraj";215;73;11;84;NA;110947;226;2020-12-20;-215300
2020-12-19;"Košický kraj";207;1309;63;1372;NA;110947;270;2020-12-19;-215526
2020-12-18;"Košický kraj";310;7707;292;7999;NA;110947;602;2020-12-18;-215796
2020-12-17;"Košický kraj";463;5101;253;5354;NA;110947;716;2020-12-17;-216398
2020-12-16;"Košický kraj";455;5725;295;6020;NA;110947;750;2020-12-16;-217114
2020-12-15;"Košický kraj";319;4787;327;5114;NA;110947;646;2020-12-15;-217864
2020-12-14;"Košický kraj";256;2905;225;3130;NA;110947;481;2020-12-14;-218510
2020-12-13;"Košický kraj";47;181;2;183;NA;110947;49;2020-12-13;-218991
2020-12-12;"Košický kraj";369;1587;118;1705;NA;110947;487;2020-12-12;-219040
2020-12-11;"Košický kraj";354;5328;256;5584;NA;110947;610;2020-12-11;-219527
2020-12-10;"Košický kraj";283;3987;174;4161;NA;110947;457;2020-12-10;-220137
2020-12-09;"Košický kraj";279;3786;166;3952;NA;110947;445;2020-12-09;-220594
2020-12-08;"Košický kraj";226;4105;355;4460;NA;110947;581;2020-12-08;-221039
2020-12-07;"Košický kraj";270;2383;106;2489;NA;110947;376;2020-12-07;-221620
2020-12-06;"Košický kraj";121;482;33;515;NA;110947;154;2020-12-06;-221996
2020-12-05;"Košický kraj";90;1096;48;1144;NA;110947;138;2020-12-05;-222150
2020-12-04;"Košický kraj";224;2680;82;2762;NA;110947;306;2020-12-04;-222288
2020-12-03;"Košický kraj";211;7717;173;7890;NA;110947;384;2020-12-03;-222594
2020-12-02;"Košický kraj";193;8132;496;8628;NA;110947;689;2020-12-02;-222978
2020-12-01;"Košický kraj";178;2237;124;2361;NA;110947;302;2020-12-01;-223667
2020-11-30;"Košický kraj";171;3598;59;3657;NA;110947;230;2020-11-30;-223969
2020-11-29;"Košický kraj";31;325;17;342;NA;110947;48;2020-11-29;-224199
2020-11-28;"Košický kraj";69;721;52;773;NA;110947;121;2020-11-28;-224247
2020-11-27;"Košický kraj";149;2921;78;2999;NA;110947;227;2020-11-27;-224368
2020-11-26;"Košický kraj";239;1234;60;1294;NA;110947;299;2020-11-26;-224595
2020-11-25;"Košický kraj";237;1785;123;1908;NA;110947;360;2020-11-25;-224894
2020-11-24;"Košický kraj";196;1976;67;2043;NA;110947;263;2020-11-24;-225254
2020-11-23;"Košický kraj";51;4115;63;4178;NA;110947;114;2020-11-23;-225517
2020-11-22;"Košický kraj";57;57;5;62;NA;110947;62;2020-11-22;-225631
2020-11-21;"Košický kraj";87;858;36;894;NA;110947;123;2020-11-21;-225693
2020-11-20;"Košický kraj";176;3084;49;3133;NA;110947;225;2020-11-20;-225816
2020-11-19;"Košický kraj";206;1736;48;1784;NA;110947;254;2020-11-19;-226041
2020-11-18;"Košický kraj";122;532;17;549;NA;110947;139;2020-11-18;-226295
2020-11-17;"Košický kraj";152;82;9;91;NA;110947;161;2020-11-17;-226434
2020-11-16;"Košický kraj";114;596;27;623;NA;110947;141;2020-11-16;-226595
2020-11-15;"Košický kraj";15;338;7;345;NA;110947;22;2020-11-15;-226736
2020-11-14;"Košický kraj";234;520;12;532;NA;110947;246;2020-11-14;-226758
2020-11-13;"Košický kraj";207;664;29;693;NA;110947;236;2020-11-13;-227004
2020-11-12;"Košický kraj";192;736;13;749;NA;110947;205;2020-11-12;-227240
2020-11-11;"Košický kraj";301;593;7;600;NA;110947;308;2020-11-11;-227445
2020-11-10;"Košický kraj";190;541;11;552;NA;110947;201;2020-11-10;-227753
2020-11-09;"Košický kraj";129;380;17;397;NA;110947;146;2020-11-09;-227954
2020-11-08;"Košický kraj";78;1306;8;1314;NA;110947;86;2020-11-08;-228100
2020-11-07;"Košický kraj";192;3909;22;3931;NA;110947;214;2020-11-07;-228186
2020-11-06;"Košický kraj";195;5310;34;5344;NA;110947;229;2020-11-06;-228400
2020-11-05;"Košický kraj";342;330;31;361;NA;110947;373;2020-11-05;-228629
2020-11-04;"Košický kraj";101;154;6;160;NA;110947;107;2020-11-04;-229002
2020-11-03;"Košický kraj";358;1122;13;1135;NA;110947;371;2020-11-03;-229109
2020-11-02;"Košický kraj";111;6125;56;6181;NA;110947;167;2020-11-02;-229480
2020-11-01;"Košický kraj";346;6522;34;6556;NA;110947;380;2020-11-01;-229647
2020-10-31;"Košický kraj";82;14035;106;14141;NA;110947;188;2020-10-31;-230027
2020-10-30;"Košický kraj";379;2835;27;2862;NA;110947;406;2020-10-30;-230215
2020-10-29;"Košický kraj";333;983;13;996;NA;110947;346;2020-10-29;-230621
2020-10-28;"Košický kraj";224;305;13;318;NA;110947;237;2020-10-28;-230967
2020-10-27;"Košický kraj";386;439;21;460;NA;110947;407;2020-10-27;-231204
2020-10-26;"Košický kraj";56;212;12;224;NA;110947;68;2020-10-26;-231611
2020-10-25;"Košický kraj";154;79;2;81;NA;110947;156;2020-10-25;-231679
2020-10-24;"Košický kraj";313;118;16;134;NA;110947;329;2020-10-24;-231835
2020-10-23;"Košický kraj";315;331;8;339;NA;110947;323;2020-10-23;-232164
2020-10-22;"Košický kraj";349;530;16;546;NA;110947;365;2020-10-22;-232487
2020-10-21;"Košický kraj";129;84;2;86;NA;110947;131;2020-10-21;-232852
2020-10-20;"Košický kraj";181;14;1;15;NA;110947;182;2020-10-20;-232983
2020-10-19;"Košický kraj";64;38;1;39;NA;110947;65;2020-10-19;-233165
2020-10-18;"Košický kraj";158;0;0;0;NA;110947;158;2020-10-18;-233230
2020-10-17;"Košický kraj";142;0;0;0;NA;110947;142;2020-10-17;-233388
2020-10-16;"Košický kraj";206;19;0;19;NA;110947;206;2020-10-16;-233530
2020-10-15;"Košický kraj";177;19;5;24;NA;110947;182;2020-10-15;-233736
2020-10-14;"Košický kraj";211;8;0;8;NA;110947;211;2020-10-14;-233918
2020-10-13;"Košický kraj";179;80;3;83;NA;110947;182;2020-10-13;-234129
2020-10-12;"Košický kraj";74;0;0;0;NA;110947;74;2020-10-12;-234311
2020-10-11;"Košický kraj";121;0;0;0;NA;110947;121;2020-10-11;-234385
2020-10-10;"Košický kraj";70;0;0;0;NA;110947;70;2020-10-10;-234506
2020-10-09;"Košický kraj";188;0;0;0;NA;110947;188;2020-10-09;-234576
2020-10-08;"Košický kraj";102;0;0;0;NA;110947;102;2020-10-08;-234764
2020-10-07;"Košický kraj";158;0;0;0;NA;110947;158;2020-10-07;-234866
2020-10-06;"Košický kraj";70;0;0;0;NA;110947;70;2020-10-06;-235024
2020-10-05;"Košický kraj";39;0;0;0;NA;110947;39;2020-10-05;-235094
2020-10-04;"Košický kraj";45;0;0;0;NA;110947;45;2020-10-04;-235133
2020-10-03;"Košický kraj";105;0;0;0;NA;110947;105;2020-10-03;-235178
2020-10-02;"Košický kraj";57;0;0;0;NA;110947;57;2020-10-02;-235283
2020-10-01;"Košický kraj";69;0;0;0;NA;110947;69;2020-10-01;-235340
2020-09-30;"Košický kraj";95;0;0;0;NA;110947;95;2020-09-30;-235409
2020-09-29;"Košický kraj";75;0;0;0;NA;110947;75;2020-09-29;-235504
2020-09-28;"Košický kraj";19;0;0;0;NA;110947;19;2020-09-28;-235579
2020-09-27;"Košický kraj";21;0;0;0;NA;110947;21;2020-09-27;-235598
2020-09-26;"Košický kraj";53;0;0;0;NA;110947;53;2020-09-26;-235619
2020-09-25;"Košický kraj";72;0;0;0;NA;110947;72;2020-09-25;-235672
2020-09-24;"Košický kraj";35;0;0;0;NA;110947;35;2020-09-24;-235744
2020-09-23;"Košický kraj";23;0;0;0;NA;110947;23;2020-09-23;-235779
2020-09-22;"Košický kraj";39;0;0;0;NA;110947;39;2020-09-22;-235802
2020-09-21;"Košický kraj";5;0;0;0;NA;110947;5;2020-09-21;-235841
2020-09-20;"Košický kraj";3;0;0;0;NA;110947;3;2020-09-20;-235846
2020-09-19;"Košický kraj";13;0;0;0;NA;110947;13;2020-09-19;-235849
2020-09-18;"Košický kraj";20;0;0;0;NA;110947;20;2020-09-18;-235862
2020-09-17;"Košický kraj";22;0;0;0;NA;110947;22;2020-09-17;-235882
2020-09-16;"Košický kraj";12;0;0;0;NA;110947;12;2020-09-16;-235904
2020-09-15;"Košický kraj";10;0;0;0;NA;110947;10;2020-09-15;-235916
2020-09-14;"Košický kraj";6;0;0;0;NA;110947;6;2020-09-14;-235926
2020-09-13;"Košický kraj";3;0;0;0;NA;110947;3;2020-09-13;-235932
2020-09-12;"Košický kraj";16;0;0;0;NA;110947;16;2020-09-12;-235935
2020-09-11;"Košický kraj";20;0;0;0;NA;110947;20;2020-09-11;-235951
2020-09-10;"Košický kraj";11;0;0;0;NA;110947;11;2020-09-10;-235971
2020-09-09;"Košický kraj";37;0;0;0;NA;110947;37;2020-09-09;-235982
2020-09-08;"Košický kraj";10;0;0;0;NA;110947;10;2020-09-08;-236019
2020-09-07;"Košický kraj";4;0;0;0;NA;110947;4;2020-09-07;-236029
2020-09-06;"Košický kraj";2;0;0;0;NA;110947;2;2020-09-06;-236033
2020-09-05;"Košický kraj";10;0;0;0;NA;110947;10;2020-09-05;-236035
2020-09-04;"Košický kraj";14;0;0;0;NA;110947;14;2020-09-04;-236045
2020-09-03;"Košický kraj";22;0;0;0;NA;110947;22;2020-09-03;-236059
2020-09-02;"Košický kraj";13;0;0;0;NA;110947;13;2020-09-02;-236081
2020-09-01;"Košický kraj";21;0;0;0;NA;110947;21;2020-09-01;-236094
2020-08-31;"Košický kraj";9;0;0;0;NA;110947;9;2020-08-31;-236115
2020-08-30;"Košický kraj";21;0;0;0;NA;110947;21;2020-08-30;-236124
2020-08-29;"Košický kraj";1;0;0;0;NA;110947;1;2020-08-29;-236145
2020-08-28;"Košický kraj";19;0;0;0;NA;110947;19;2020-08-28;-236146
2020-08-27;"Košický kraj";15;0;0;0;NA;110947;15;2020-08-27;-236165
2020-08-26;"Košický kraj";8;0;0;0;NA;110947;8;2020-08-26;-236180
2020-08-25;"Košický kraj";23;0;0;0;NA;110947;23;2020-08-25;-236188
2020-08-24;"Košický kraj";6;0;0;0;NA;110947;6;2020-08-24;-236211
2020-08-23;"Košický kraj";8;0;0;0;NA;110947;8;2020-08-23;-236217
2020-08-22;"Košický kraj";13;0;0;0;NA;110947;13;2020-08-22;-236225
2020-08-21;"Košický kraj";10;0;0;0;NA;110947;10;2020-08-21;-236238
2020-08-20;"Košický kraj";10;0;0;0;NA;110947;10;2020-08-20;-236248
2020-08-19;"Košický kraj";3;0;0;0;NA;110947;3;2020-08-19;-236258
2020-08-18;"Košický kraj";7;0;0;0;NA;110947;7;2020-08-18;-236261
2020-08-17;"Košický kraj";2;0;0;0;NA;110947;2;2020-08-17;-236268
2020-08-16;"Košický kraj";2;0;0;0;NA;110947;2;2020-08-16;-236270
2020-08-15;"Košický kraj";3;0;0;0;NA;110947;3;2020-08-15;-236272
2020-08-14;"Košický kraj";1;0;0;0;NA;110947;1;2020-08-14;-236275
2020-08-13;"Košický kraj";3;0;0;0;NA;110947;3;2020-08-13;-236276
2020-08-12;"Košický kraj";12;0;0;0;NA;110947;12;2020-08-12;-236279
2020-08-11;"Košický kraj";5;0;0;0;NA;110947;5;2020-08-11;-236291
2020-08-10;"Košický kraj";1;0;0;0;NA;110947;1;2020-08-10;-236296
2020-08-09;"Košický kraj";0;0;0;0;NA;110947;0;2020-08-09;-236297
2020-08-08;"Košický kraj";5;0;0;0;NA;110947;5;2020-08-08;-236297
2020-08-07;"Košický kraj";7;0;0;0;NA;110947;7;2020-08-07;-236302
2020-08-06;"Košický kraj";3;0;0;0;NA;110947;3;2020-08-06;-236309
2020-08-05;"Košický kraj";4;0;0;0;NA;110947;4;2020-08-05;-236312
2020-08-04;"Košický kraj";1;0;0;0;NA;110947;1;2020-08-04;-236316
2020-08-03;"Košický kraj";1;0;0;0;NA;110947;1;2020-08-03;-236317
2020-08-02;"Košický kraj";0;0;0;0;NA;110947;0;2020-08-02;-236318
2020-08-01;"Košický kraj";0;0;0;0;NA;110947;0;2020-08-01;-236318
2020-07-31;"Košický kraj";0;0;0;0;NA;110947;0;2020-07-31;-236318
2020-07-30;"Košický kraj";2;0;0;0;NA;110947;2;2020-07-30;-236318
2020-07-29;"Košický kraj";1;0;0;0;NA;110947;1;2020-07-29;-236320
2020-07-28;"Košický kraj";9;0;0;0;NA;110947;9;2020-07-28;-236321
2020-07-27;"Košický kraj";4;0;0;0;NA;110947;4;2020-07-27;-236330
2020-07-26;"Košický kraj";0;0;0;0;NA;110947;0;2020-07-26;-236334
2020-07-25;"Košický kraj";2;0;0;0;NA;110947;2;2020-07-25;-236334
2020-07-24;"Košický kraj";2;0;0;0;NA;110947;2;2020-07-24;-236336
2020-07-23;"Košický kraj";1;0;0;0;NA;110947;1;2020-07-23;-236338
2020-07-22;"Košický kraj";1;0;0;0;NA;110947;1;2020-07-22;-236339
2020-07-21;"Košický kraj";0;0;0;0;NA;110947;0;2020-07-21;-236340
2020-07-20;"Košický kraj";0;0;0;0;NA;110947;0;2020-07-20;-236340
2020-07-19;"Košický kraj";0;0;0;0;NA;110947;0;2020-07-19;-236340
2020-07-18;"Košický kraj";1;0;0;0;NA;110947;1;2020-07-18;-236340
2020-07-17;"Košický kraj";1;0;0;0;NA;110947;1;2020-07-17;-236341
2020-07-16;"Košický kraj";0;0;0;0;NA;110947;0;2020-07-16;-236342
2020-07-15;"Košický kraj";2;0;0;0;NA;110947;2;2020-07-15;-236342
2020-07-14;"Košický kraj";1;0;0;0;NA;110947;1;2020-07-14;-236344
2020-07-13;"Košický kraj";1;0;0;0;NA;110947;1;2020-07-13;-236345
2020-07-12;"Košický kraj";0;0;0;0;NA;110947;0;2020-07-12;-236346
2020-07-11;"Košický kraj";0;0;0;0;NA;110947;0;2020-07-11;-236346
2020-07-10;"Košický kraj";1;0;0;0;NA;110947;1;2020-07-10;-236346
2020-07-09;"Košický kraj";1;0;0;0;NA;110947;1;2020-07-09;-236347
2020-07-08;"Košický kraj";12;0;0;0;NA;110947;12;2020-07-08;-236348
2020-07-07;"Košický kraj";0;0;0;0;NA;110947;0;2020-07-07;-236360
2020-07-06;"Košický kraj";0;0;0;0;NA;110947;0;2020-07-06;-236360
2020-07-05;"Košický kraj";0;0;0;0;NA;110947;0;2020-07-05;-236360
2020-07-04;"Košický kraj";0;0;0;0;NA;110947;0;2020-07-04;-236360
2020-07-03;"Košický kraj";1;0;0;0;NA;110947;1;2020-07-03;-236360
2020-07-02;"Košický kraj";0;0;0;0;NA;110947;0;2020-07-02;-236361
2020-07-01;"Košický kraj";1;0;0;0;NA;110947;1;2020-07-01;-236361
2020-06-30;"Košický kraj";0;0;0;0;NA;110947;0;2020-06-30;-236362
2020-06-29;"Košický kraj";0;0;0;0;NA;110947;0;2020-06-29;-236362
2020-06-28;"Košický kraj";0;0;0;0;NA;110947;0;2020-06-28;-236362
2020-06-27;"Košický kraj";0;0;0;0;NA;110947;0;2020-06-27;-236362
2020-06-26;"Košický kraj";0;0;0;0;NA;110947;0;2020-06-26;-236362
2020-06-25;"Košický kraj";3;0;0;0;NA;110947;3;2020-06-25;-236362
2020-06-24;"Košický kraj";3;0;0;0;NA;110947;3;2020-06-24;-236365
2020-06-23;"Košický kraj";3;0;0;0;NA;110947;3;2020-06-23;-236368
2020-06-22;"Košický kraj";0;0;0;0;NA;110947;0;2020-06-22;-236371
2020-06-21;"Košický kraj";0;0;0;0;NA;110947;0;2020-06-21;-236371
2020-06-20;"Košický kraj";0;0;0;0;NA;110947;0;2020-06-20;-236371
2020-06-19;"Košický kraj";0;0;0;0;NA;110947;0;2020-06-19;-236371
2020-06-18;"Košický kraj";1;0;0;0;NA;110947;1;2020-06-18;-236371
2020-06-17;"Košický kraj";0;0;0;0;NA;110947;0;2020-06-17;-236372
2020-06-16;"Košický kraj";2;0;0;0;NA;110947;2;2020-06-16;-236372
2020-06-14;"Košický kraj";0;0;0;0;NA;110947;0;2020-06-14;-236374
2020-06-13;"Košický kraj";0;0;0;0;NA;110947;0;2020-06-13;-236374
2020-06-12;"Košický kraj";0;0;0;0;NA;110947;0;2020-06-12;-236374
2020-06-11;"Košický kraj";0;0;0;0;NA;110947;0;2020-06-11;-236374
2020-06-10;"Košický kraj";6;0;0;0;NA;110947;6;2020-06-10;-236374
2020-06-09;"Košický kraj";0;0;0;0;NA;110947;0;2020-06-09;-236380
2020-06-08;"Košický kraj";0;0;0;0;NA;110947;0;2020-06-08;-236380
2020-06-07;"Košický kraj";2;0;0;0;NA;110947;2;2020-06-07;-236380
2020-06-05;"Košický kraj";0;0;0;0;NA;110947;0;2020-06-05;-236382
2020-06-03;"Košický kraj";0;0;0;0;NA;110947;0;2020-06-03;-236382
2020-06-02;"Košický kraj";1;0;0;0;NA;110947;1;2020-06-02;-236382
2020-05-31;"Košický kraj";0;0;0;0;NA;110947;0;2020-05-31;-236383
2020-05-29;"Košický kraj";1;0;0;0;NA;110947;1;2020-05-29;-236383
2020-05-27;"Košický kraj";0;0;0;0;NA;110947;0;2020-05-27;-236384
2020-05-26;"Košický kraj";1;0;0;0;NA;110947;1;2020-05-26;-236384
2020-05-25;"Košický kraj";1;0;0;0;NA;110947;1;2020-05-25;-236385
2020-05-24;"Košický kraj";0;0;0;0;NA;110947;0;2020-05-24;-236386
2020-05-23;"Košický kraj";0;0;0;0;NA;110947;0;2020-05-23;-236386
2020-05-22;"Košický kraj";0;0;0;0;NA;110947;0;2020-05-22;-236386
2020-05-21;"Košický kraj";0;0;0;0;NA;110947;0;2020-05-21;-236386
2020-05-20;"Košický kraj";3;0;0;0;NA;110947;3;2020-05-20;-236386
2020-05-19;"Košický kraj";0;0;0;0;NA;110947;0;2020-05-19;-236389
2020-05-17;"Košický kraj";1;0;0;0;NA;110947;1;2020-05-17;-236389
2020-05-16;"Košický kraj";1;0;0;0;NA;110947;1;2020-05-16;-236390
2020-05-15;"Košický kraj";10;0;0;0;NA;110947;10;2020-05-15;-236391
2020-05-14;"Košický kraj";1;0;0;0;NA;110947;1;2020-05-14;-236401
2020-05-13;"Košický kraj";6;0;0;0;NA;110947;6;2020-05-13;-236402
2020-05-12;"Košický kraj";0;0;0;0;NA;110947;0;2020-05-12;-236408
2020-05-11;"Košický kraj";0;0;0;0;NA;110947;0;2020-05-11;-236408
2020-05-09;"Košický kraj";0;0;0;0;NA;110947;0;2020-05-09;-236408
2020-05-07;"Košický kraj";0;0;0;0;NA;110947;0;2020-05-07;-236408
2020-05-06;"Košický kraj";1;0;0;0;NA;110947;1;2020-05-06;-236408
2020-05-05;"Košický kraj";0;0;0;0;NA;110947;0;2020-05-05;-236409
2020-05-04;"Košický kraj";0;0;0;0;NA;110947;0;2020-05-04;-236409
2020-05-03;"Košický kraj";0;0;0;0;NA;110947;0;2020-05-03;-236409
2020-05-02;"Košický kraj";1;0;0;0;NA;110947;1;2020-05-02;-236409
2020-05-01;"Košický kraj";0;0;0;0;NA;110947;0;2020-05-01;-236410
2020-04-30;"Košický kraj";1;0;0;0;NA;110947;1;2020-04-30;-236410
2020-04-29;"Košický kraj";1;0;0;0;NA;110947;1;2020-04-29;-236411
2020-04-28;"Košický kraj";1;0;0;0;NA;110947;1;2020-04-28;-236412
2020-04-27;"Košický kraj";1;0;0;0;NA;110947;1;2020-04-27;-236413
2020-04-26;"Košický kraj";0;0;0;0;NA;110947;0;2020-04-26;-236414
2020-04-25;"Košický kraj";0;0;0;0;NA;110947;0;2020-04-25;-236414
2020-04-24;"Košický kraj";3;0;0;0;NA;110947;3;2020-04-24;-236414
2020-04-23;"Košický kraj";4;0;0;0;NA;110947;4;2020-04-23;-236417
2020-04-22;"Košický kraj";21;0;0;0;NA;110947;21;2020-04-22;-236421
2020-04-21;"Košický kraj";4;0;0;0;NA;110947;4;2020-04-21;-236442
2020-04-20;"Košický kraj";0;0;0;0;NA;110947;0;2020-04-20;-236446
2020-04-19;"Košický kraj";1;0;0;0;NA;110947;1;2020-04-19;-236446
2020-04-18;"Košický kraj";2;0;0;0;NA;110947;2;2020-04-18;-236447
2020-04-17;"Košický kraj";7;0;0;0;NA;110947;7;2020-04-17;-236449
2020-04-16;"Košický kraj";29;0;0;0;NA;110947;29;2020-04-16;-236456
2020-04-15;"Košický kraj";50;0;0;0;NA;110947;50;2020-04-15;-236485
2020-04-14;"Košický kraj";4;0;0;0;NA;110947;4;2020-04-14;-236535
2020-04-13;"Košický kraj";5;0;0;0;NA;110947;5;2020-04-13;-236539
2020-04-12;"Košický kraj";4;0;0;0;NA;110947;4;2020-04-12;-236544
2020-04-11;"Košický kraj";2;0;0;0;NA;110947;2;2020-04-11;-236548
2020-04-10;"Košický kraj";1;0;0;0;NA;110947;1;2020-04-10;-236550
2020-04-09;"Košický kraj";4;0;0;0;NA;110947;4;2020-04-09;-236551
2020-04-08;"Košický kraj";5;0;0;0;NA;110947;5;2020-04-08;-236555
2020-04-07;"Košický kraj";34;0;0;0;NA;110947;34;2020-04-07;-236560
2020-04-06;"Košický kraj";6;0;0;0;NA;110947;6;2020-04-06;-236594
2020-04-05;"Košický kraj";4;0;0;0;NA;110947;4;2020-04-05;-236600
2020-04-04;"Košický kraj";5;0;0;0;NA;110947;5;2020-04-04;-236604
2020-04-03;"Košický kraj";4;0;0;0;NA;110947;4;2020-04-03;-236609
2020-04-02;"Košický kraj";3;0;0;0;NA;110947;3;2020-04-02;-236613
2020-04-01;"Košický kraj";3;0;0;0;NA;110947;3;2020-04-01;-236616
2020-03-31;"Košický kraj";1;0;0;0;NA;110947;1;2020-03-31;-236619
2020-03-30;"Košický kraj";5;0;0;0;NA;110947;5;2020-03-30;-236620
2020-03-29;"Košický kraj";0;0;0;0;NA;110947;0;2020-03-29;-236625
2020-03-28;"Košický kraj";1;0;0;0;NA;110947;1;2020-03-28;-236625
2020-03-27;"Košický kraj";1;0;0;0;NA;110947;1;2020-03-27;-236626
2020-03-26;"Košický kraj";3;0;0;0;NA;110947;3;2020-03-26;-236627
2020-03-25;"Košický kraj";2;0;0;0;NA;110947;2;2020-03-25;-236630
2020-03-24;"Košický kraj";0;0;0;0;NA;110947;0;2020-03-24;-236632
2020-03-23;"Košický kraj";2;0;0;0;NA;110947;2;2020-03-23;-236632
2020-03-22;"Košický kraj";0;0;0;0;NA;110947;0;2020-03-22;-236634
2020-03-21;"Košický kraj";3;0;0;0;NA;110947;3;2020-03-21;-236634
2020-03-20;"Košický kraj";1;0;0;0;NA;110947;1;2020-03-20;-236637
2020-03-19;"Košický kraj";0;0;0;0;NA;110947;0;2020-03-19;-236638
2020-03-18;"Košický kraj";0;0;0;0;NA;110947;0;2020-03-18;-236638
2020-03-17;"Košický kraj";0;0;0;0;NA;110947;0;2020-03-17;-236638
2020-03-16;"Košický kraj";3;0;0;0;NA;110947;3;2020-03-16;-236638
2020-03-15;"Košický kraj";1;0;0;0;NA;110947;1;2020-03-15;-236641
2020-03-14;"Košický kraj";0;0;0;0;NA;110947;0;2020-03-14;-236642
2020-03-13;"Košický kraj";2;0;0;0;NA;110947;2;2020-03-13;-236642
2020-03-12;"Košický kraj";0;0;0;0;NA;110947;0;2020-03-12;-236644
2020-03-11;"Košický kraj";0;0;0;0;NA;110947;0;2020-03-11;-236644
2020-03-09;"Košický kraj";1;0;0;0;NA;110947;1;2020-03-09;-236644
2020-03-08;"Košický kraj";0;0;0;0;NA;110947;0;2020-03-08;-236645
2020-03-07;"Košický kraj";0;0;0;0;NA;110947;0;2020-03-07;-236645
2020-03-06;"Košický kraj";0;0;0;0;NA;110947;0;2020-03-06;-236645
2022-06-26;"Nitriansky kraj";4;3;1;4;NA;98786;5;2022-06-26;98786
2022-06-25;"Nitriansky kraj";8;8;4;12;NA;98786;12;2022-06-25;98781
2022-06-24;"Nitriansky kraj";57;67;4;71;NA;98786;61;2022-06-24;98769
2022-06-23;"Nitriansky kraj";44;65;4;69;NA;98786;48;2022-06-23;98708
2022-06-22;"Nitriansky kraj";36;103;5;108;NA;98786;41;2022-06-22;98660
2022-06-21;"Nitriansky kraj";33;111;7;118;NA;98786;40;2022-06-21;98619
2022-06-20;"Nitriansky kraj";30;110;7;117;NA;98786;37;2022-06-20;98579
2022-06-19;"Nitriansky kraj";4;74;5;79;NA;98786;9;2022-06-19;98542
2022-06-18;"Nitriansky kraj";4;6;1;7;NA;98786;5;2022-06-18;98533
2022-06-17;"Nitriansky kraj";11;68;8;76;NA;98786;19;2022-06-17;98528
2022-06-16;"Nitriansky kraj";19;109;1;110;NA;98786;20;2022-06-16;98509
2022-06-15;"Nitriansky kraj";13;81;5;86;NA;98786;18;2022-06-15;98489
2022-06-14;"Nitriansky kraj";19;158;1;159;NA;98786;20;2022-06-14;98471
2022-06-13;"Nitriansky kraj";15;103;5;108;NA;98786;20;2022-06-13;98451
2022-06-12;"Nitriansky kraj";2;36;0;36;NA;98786;2;2022-06-12;98431
2022-06-11;"Nitriansky kraj";3;10;0;10;NA;98786;3;2022-06-11;98429
2022-06-10;"Nitriansky kraj";8;49;3;52;NA;98786;11;2022-06-10;98426
2022-06-09;"Nitriansky kraj";10;129;6;135;NA;98786;16;2022-06-09;98415
2022-06-08;"Nitriansky kraj";14;64;6;70;NA;98786;20;2022-06-08;98399
2022-06-07;"Nitriansky kraj";15;58;4;62;NA;98786;19;2022-06-07;98379
2022-06-06;"Nitriansky kraj";14;117;2;119;NA;98786;16;2022-06-06;98360
2022-06-05;"Nitriansky kraj";0;36;0;36;NA;98786;0;2022-06-05;98344
2022-06-04;"Nitriansky kraj";2;8;0;8;NA;98786;2;2022-06-04;98344
2022-06-03;"Nitriansky kraj";4;70;2;72;NA;98786;6;2022-06-03;98342
2022-06-02;"Nitriansky kraj";1;111;0;111;NA;98786;1;2022-06-02;98336
2022-06-01;"Nitriansky kraj";15;95;2;97;NA;98786;17;2022-06-01;98335
2022-05-31;"Nitriansky kraj";17;73;1;74;NA;98786;18;2022-05-31;98318
2022-05-30;"Nitriansky kraj";14;162;4;166;NA;98786;18;2022-05-30;98300
2022-05-29;"Nitriansky kraj";0;47;0;47;NA;98786;0;2022-05-29;98282
2022-05-28;"Nitriansky kraj";3;16;1;17;NA;98786;4;2022-05-28;98282
2022-05-27;"Nitriansky kraj";9;90;5;95;NA;98786;14;2022-05-27;98278
2022-05-26;"Nitriansky kraj";17;183;3;186;NA;98786;20;2022-05-26;98264
2022-05-25;"Nitriansky kraj";14;172;8;180;NA;98786;22;2022-05-25;98244
2022-05-24;"Nitriansky kraj";14;138;1;139;NA;98786;15;2022-05-24;98222
2022-05-23;"Nitriansky kraj";10;229;6;235;NA;98786;16;2022-05-23;98207
2022-05-22;"Nitriansky kraj";1;78;0;78;NA;98786;1;2022-05-22;98191
2022-05-21;"Nitriansky kraj";9;109;7;116;NA;98786;16;2022-05-21;98190
2022-05-20;"Nitriansky kraj";19;78;2;80;NA;98786;21;2022-05-20;98174
2022-05-19;"Nitriansky kraj";16;132;2;134;NA;98786;18;2022-05-19;98153
2022-05-18;"Nitriansky kraj";18;250;5;255;NA;98786;23;2022-05-18;98135
2022-05-17;"Nitriansky kraj";25;173;3;176;NA;98786;28;2022-05-17;98112
2022-05-16;"Nitriansky kraj";39;246;7;253;NA;98786;46;2022-05-16;98084
2022-05-15;"Nitriansky kraj";8;70;3;73;NA;98786;11;2022-05-15;98038
2022-05-14;"Nitriansky kraj";12;26;1;27;NA;98786;13;2022-05-14;98027
2022-05-13;"Nitriansky kraj";39;146;10;156;NA;98786;49;2022-05-13;98014
2022-05-12;"Nitriansky kraj";18;150;10;160;NA;98786;28;2022-05-12;97965
2022-05-11;"Nitriansky kraj";35;204;9;213;NA;98786;44;2022-05-11;97937
2022-05-10;"Nitriansky kraj";26;201;5;206;NA;98786;31;2022-05-10;97893
2022-05-09;"Nitriansky kraj";38;283;11;294;NA;98786;49;2022-05-09;97862
2022-05-08;"Nitriansky kraj";0;95;8;103;NA;98786;8;2022-05-08;97813
2022-05-07;"Nitriansky kraj";11;27;1;28;NA;98786;12;2022-05-07;97805
2022-05-06;"Nitriansky kraj";47;186;8;194;NA;98786;55;2022-05-06;97793
2022-05-05;"Nitriansky kraj";45;261;8;269;NA;98786;53;2022-05-05;97738
2022-05-04;"Nitriansky kraj";59;298;18;316;NA;98786;77;2022-05-04;97685
2022-05-03;"Nitriansky kraj";65;319;9;328;NA;98786;74;2022-05-03;97608
2022-05-02;"Nitriansky kraj";69;650;30;680;NA;98786;99;2022-05-02;97534
2022-05-01;"Nitriansky kraj";12;194;8;202;NA;98786;20;2022-05-01;97435
2022-04-30;"Nitriansky kraj";64;206;10;216;NA;98786;74;2022-04-30;97415
2022-04-29;"Nitriansky kraj";93;582;14;596;NA;98786;107;2022-04-29;97341
2022-04-28;"Nitriansky kraj";93;841;19;860;NA;98786;112;2022-04-28;97234
2022-04-27;"Nitriansky kraj";126;731;24;755;NA;98786;150;2022-04-27;97122
2022-04-26;"Nitriansky kraj";156;885;29;914;NA;98786;185;2022-04-26;96972
2022-04-25;"Nitriansky kraj";136;1120;52;1172;NA;98786;188;2022-04-25;96787
2022-04-24;"Nitriansky kraj";48;296;12;308;NA;98786;60;2022-04-24;96599
2022-04-23;"Nitriansky kraj";79;250;5;255;NA;98786;84;2022-04-23;96539
2022-04-22;"Nitriansky kraj";101;748;26;774;NA;98786;127;2022-04-22;96455
2022-04-21;"Nitriansky kraj";219;803;15;818;NA;98786;234;2022-04-21;96328
2022-04-20;"Nitriansky kraj";194;1014;33;1047;NA;98786;227;2022-04-20;96094
2022-04-19;"Nitriansky kraj";234;2112;83;2195;NA;98786;317;2022-04-19;95867
2022-04-18;"Nitriansky kraj";111;520;14;534;NA;98786;125;2022-04-18;95550
2022-04-17;"Nitriansky kraj";136;258;8;266;NA;98786;144;2022-04-17;95425
2022-04-16;"Nitriansky kraj";87;362;24;386;NA;98786;111;2022-04-16;95281
2022-04-15;"Nitriansky kraj";105;402;10;412;NA;98786;115;2022-04-15;95170
2022-04-14;"Nitriansky kraj";255;721;32;753;NA;98786;287;2022-04-14;95055
2022-04-13;"Nitriansky kraj";223;909;60;969;NA;98786;283;2022-04-13;94768
2022-04-12;"Nitriansky kraj";291;1043;60;1103;NA;98786;351;2022-04-12;94485
2022-04-11;"Nitriansky kraj";278;1676;101;1777;NA;98786;379;2022-04-11;94134
2022-04-10;"Nitriansky kraj";154;512;43;555;NA;98786;197;2022-04-10;93755
2022-04-09;"Nitriansky kraj";176;391;29;420;NA;98786;205;2022-04-09;93558
2022-04-08;"Nitriansky kraj";363;1071;76;1147;NA;98786;439;2022-04-08;93353
2022-04-07;"Nitriansky kraj";427;1298;115;1413;NA;98786;542;2022-04-07;92914
2022-04-06;"Nitriansky kraj";406;1191;98;1289;NA;98786;504;2022-04-06;92372
2022-04-05;"Nitriansky kraj";783;1195;110;1305;NA;98786;893;2022-04-05;91868
2022-04-04;"Nitriansky kraj";572;1577;152;1729;NA;98786;724;2022-04-04;90975
2022-04-03;"Nitriansky kraj";199;918;98;1016;NA;98786;297;2022-04-03;90251
2022-04-02;"Nitriansky kraj";362;450;45;495;NA;98786;407;2022-04-02;89954
2022-04-01;"Nitriansky kraj";614;1283;129;1412;NA;98786;743;2022-04-01;89547
2022-03-31;"Nitriansky kraj";685;1558;159;1717;NA;98786;844;2022-03-31;88804
2022-03-30;"Nitriansky kraj";751;1239;132;1371;NA;98786;883;2022-03-30;87960
2022-03-29;"Nitriansky kraj";1187;1523;175;1698;NA;98786;1362;2022-03-29;87077
2022-03-28;"Nitriansky kraj";711;1959;288;2247;NA;98786;999;2022-03-28;85715
2022-03-27;"Nitriansky kraj";463;790;148;938;NA;98786;611;2022-03-27;84716
2022-03-26;"Nitriansky kraj";653;408;83;491;NA;98786;736;2022-03-26;84105
2022-03-25;"Nitriansky kraj";918;1134;220;1354;NA;98786;1138;2022-03-25;83369
2022-03-24;"Nitriansky kraj";1391;1262;194;1456;NA;98786;1585;2022-03-24;82231
2022-03-23;"Nitriansky kraj";1401;1461;232;1693;NA;98786;1633;2022-03-23;80646
2022-03-22;"Nitriansky kraj";1360;1553;199;1752;NA;98786;1559;2022-03-22;79013
2022-03-21;"Nitriansky kraj";1304;2138;351;2489;NA;98786;1655;2022-03-21;77454
2022-03-20;"Nitriansky kraj";552;933;226;1159;NA;98786;778;2022-03-20;75799
2022-03-19;"Nitriansky kraj";839;424;146;570;NA;98786;985;2022-03-19;75021
2022-03-18;"Nitriansky kraj";1205;1207;271;1478;NA;98786;1476;2022-03-18;74036
2022-03-17;"Nitriansky kraj";1734;1473;236;1709;NA;98786;1970;2022-03-17;72560
2022-03-16;"Nitriansky kraj";1214;1477;232;1709;NA;98786;1446;2022-03-16;70590
2022-03-15;"Nitriansky kraj";1590;1566;256;1822;NA;98786;1846;2022-03-15;69144
2022-03-14;"Nitriansky kraj";1325;2636;384;3020;NA;98786;1709;2022-03-14;67298
2022-03-13;"Nitriansky kraj";527;992;202;1194;NA;98786;729;2022-03-13;65589
2022-03-12;"Nitriansky kraj";711;739;169;908;NA;98786;880;2022-03-12;64860
2022-03-11;"Nitriansky kraj";1085;1897;365;2262;NA;98786;1450;2022-03-11;63980
2022-03-10;"Nitriansky kraj";1403;2015;313;2328;NA;98786;1716;2022-03-10;62530
2022-03-09;"Nitriansky kraj";1452;2121;323;2444;NA;98786;1775;2022-03-09;60814
2022-03-08;"Nitriansky kraj";1695;2542;350;2892;NA;98786;2045;2022-03-08;59039
2022-03-07;"Nitriansky kraj";1115;3392;521;3913;NA;98786;1636;2022-03-07;56994
2022-03-06;"Nitriansky kraj";566;1509;350;1859;NA;98786;916;2022-03-06;55358
2022-03-05;"Nitriansky kraj";614;1239;214;1453;NA;98786;828;2022-03-05;54442
2022-03-04;"Nitriansky kraj";1315;1602;323;1925;NA;98786;1638;2022-03-04;53614
2022-03-03;"Nitriansky kraj";1405;2944;379;3323;NA;98786;1784;2022-03-03;51976
2022-03-02;"Nitriansky kraj";1417;2723;422;3145;NA;98786;1839;2022-03-02;50192
2022-03-01;"Nitriansky kraj";1380;2422;412;2834;NA;98786;1792;2022-03-01;48353
2022-02-28;"Nitriansky kraj";1577;4825;599;5424;NA;98786;2176;2022-02-28;46561
2022-02-27;"Nitriansky kraj";797;1271;294;1565;NA;98786;1091;2022-02-27;44385
2022-02-26;"Nitriansky kraj";895;799;217;1016;NA;98786;1112;2022-02-26;43294
2022-02-25;"Nitriansky kraj";1400;2321;339;2660;NA;98786;1739;2022-02-25;42182
2022-02-24;"Nitriansky kraj";1592;3586;389;3975;NA;98786;1981;2022-02-24;40443
2022-02-23;"Nitriansky kraj";1885;3936;476;4412;NA;98786;2361;2022-02-23;38462
2022-02-22;"Nitriansky kraj";2323;3849;502;4351;NA;98786;2825;2022-02-22;36101
2022-02-21;"Nitriansky kraj";1593;6255;816;7071;NA;98786;2409;2022-02-21;33276
2022-02-20;"Nitriansky kraj";1049;1987;439;2426;NA;98786;1488;2022-02-20;30867
2022-02-19;"Nitriansky kraj";1084;1341;336;1677;NA;98786;1420;2022-02-19;29379
2022-02-18;"Nitriansky kraj";2021;3284;583;3867;NA;98786;2604;2022-02-18;27959
2022-02-17;"Nitriansky kraj";2134;3890;480;4370;NA;98786;2614;2022-02-17;25355
2022-02-16;"Nitriansky kraj";2152;3948;532;4480;NA;98786;2684;2022-02-16;22741
2022-02-15;"Nitriansky kraj";2093;4069;780;4849;NA;98786;2873;2022-02-15;20057
2022-02-14;"Nitriansky kraj";2094;6258;921;7179;NA;98786;3015;2022-02-14;17184
2022-02-13;"Nitriansky kraj";1146;2832;547;3379;NA;98786;1693;2022-02-13;14169
2022-02-12;"Nitriansky kraj";1301;1171;343;1514;NA;98786;1644;2022-02-12;12476
2022-02-11;"Nitriansky kraj";2042;2949;561;3510;NA;98786;2603;2022-02-11;10832
2022-02-10;"Nitriansky kraj";2374;3366;537;3903;NA;98786;2911;2022-02-10;8229
2022-02-09;"Nitriansky kraj";2133;4808;653;5461;NA;98786;2786;2022-02-09;5318
2022-02-08;"Nitriansky kraj";1801;4935;736;5671;NA;98786;2537;2022-02-08;2532
2022-02-07;"Nitriansky kraj";2240;6807;762;7569;NA;98786;3002;2022-02-07;-5
2022-02-06;"Nitriansky kraj";1309;2690;494;3184;NA;98786;1803;2022-02-06;-3007
2022-02-05;"Nitriansky kraj";1609;1504;358;1862;NA;98786;1967;2022-02-05;-4810
2022-02-04;"Nitriansky kraj";1848;4189;510;4699;NA;98786;2358;2022-02-04;-6777
2022-02-03;"Nitriansky kraj";2425;4186;491;4677;NA;98786;2916;2022-02-03;-9135
2022-02-02;"Nitriansky kraj";1903;5326;766;6092;NA;98786;2669;2022-02-02;-12051
2022-02-01;"Nitriansky kraj";2288;4717;597;5314;NA;98786;2885;2022-02-01;-14720
2022-01-31;"Nitriansky kraj";1329;8991;746;9737;NA;98786;2075;2022-01-31;-17605
2022-01-30;"Nitriansky kraj";777;3498;471;3969;NA;98786;1248;2022-01-30;-19680
2022-01-29;"Nitriansky kraj";1099;1670;298;1968;NA;98786;1397;2022-01-29;-20928
2022-01-28;"Nitriansky kraj";1610;4217;374;4591;NA;98786;1984;2022-01-28;-22325
2022-01-27;"Nitriansky kraj";1429;3796;289;4085;NA;98786;1718;2022-01-27;-24309
2022-01-26;"Nitriansky kraj";1392;4450;306;4756;NA;98786;1698;2022-01-26;-26027
2022-01-25;"Nitriansky kraj";1591;4624;426;5050;NA;98786;2017;2022-01-25;-27725
2022-01-24;"Nitriansky kraj";770;7462;359;7821;NA;98786;1129;2022-01-24;-29742
2022-01-23;"Nitriansky kraj";327;3109;205;3314;NA;98786;532;2022-01-23;-30871
2022-01-22;"Nitriansky kraj";596;1974;153;2127;NA;98786;749;2022-01-22;-31403
2022-01-21;"Nitriansky kraj";532;3476;141;3617;NA;98786;673;2022-01-21;-32152
2022-01-20;"Nitriansky kraj";737;3537;129;3666;NA;98786;866;2022-01-20;-32825
2022-01-19;"Nitriansky kraj";614;4587;121;4708;NA;98786;735;2022-01-19;-33691
2022-01-18;"Nitriansky kraj";650;3329;125;3454;NA;98786;775;2022-01-18;-34426
2022-01-17;"Nitriansky kraj";439;7784;152;7936;NA;98786;591;2022-01-17;-35201
2022-01-16;"Nitriansky kraj";140;3191;71;3262;NA;98786;211;2022-01-16;-35792
2022-01-15;"Nitriansky kraj";268;1651;50;1701;NA;98786;318;2022-01-15;-36003
2022-01-14;"Nitriansky kraj";167;2906;68;2974;NA;98786;235;2022-01-14;-36321
2022-01-13;"Nitriansky kraj";244;3297;53;3350;NA;98786;297;2022-01-13;-36556
2022-01-12;"Nitriansky kraj";298;4329;66;4395;NA;98786;364;2022-01-12;-36853
2022-01-11;"Nitriansky kraj";424;3990;50;4040;NA;98786;474;2022-01-11;-37217
2022-01-10;"Nitriansky kraj";292;7654;71;7725;NA;98786;363;2022-01-10;-37691
2022-01-09;"Nitriansky kraj";100;3419;48;3467;NA;98786;148;2022-01-09;-38054
2022-01-08;"Nitriansky kraj";206;1352;47;1399;NA;98786;253;2022-01-08;-38202
2022-01-07;"Nitriansky kraj";326;2976;74;3050;NA;98786;400;2022-01-07;-38455
2022-01-06;"Nitriansky kraj";125;910;33;943;NA;98786;158;2022-01-06;-38855
2022-01-05;"Nitriansky kraj";357;4232;66;4298;NA;98786;423;2022-01-05;-39013
2022-01-04;"Nitriansky kraj";453;3697;85;3782;NA;98786;538;2022-01-04;-39436
2022-01-03;"Nitriansky kraj";353;7378;117;7495;NA;98786;470;2022-01-03;-39974
2022-01-02;"Nitriansky kraj";25;3035;95;3130;NA;98786;120;2022-01-02;-40444
2022-01-01;"Nitriansky kraj";71;177;9;186;NA;98786;80;2022-01-01;-40564
2021-12-31;"Nitriansky kraj";382;1506;69;1575;NA;98786;451;2021-12-31;-40644
2021-12-30;"Nitriansky kraj";325;3330;89;3419;NA;98786;414;2021-12-30;-41095
2021-12-29;"Nitriansky kraj";347;2371;61;2432;NA;98786;408;2021-12-29;-41509
2021-12-28;"Nitriansky kraj";628;2501;88;2589;NA;98786;716;2021-12-28;-41917
2021-12-27;"Nitriansky kraj";402;4253;169;4422;NA;98786;571;2021-12-27;-42633
2021-12-26;"Nitriansky kraj";84;1039;53;1092;NA;98786;137;2021-12-26;-43204
2021-12-25;"Nitriansky kraj";22;499;31;530;NA;98786;53;2021-12-25;-43341
2021-12-24;"Nitriansky kraj";175;448;26;474;NA;98786;201;2021-12-24;-43394
2021-12-23;"Nitriansky kraj";472;3420;110;3530;NA;98786;582;2021-12-23;-43595
2021-12-22;"Nitriansky kraj";398;3517;95;3612;NA;98786;493;2021-12-22;-44177
2021-12-21;"Nitriansky kraj";735;2913;93;3006;NA;98786;828;2021-12-21;-44670
2021-12-20;"Nitriansky kraj";407;6754;169;6923;NA;98786;576;2021-12-20;-45498
2021-12-19;"Nitriansky kraj";198;3587;98;3685;NA;98786;296;2021-12-19;-46074
2021-12-18;"Nitriansky kraj";361;1456;96;1552;NA;98786;457;2021-12-18;-46370
2021-12-17;"Nitriansky kraj";409;4934;153;5087;NA;98786;562;2021-12-17;-46827
2021-12-16;"Nitriansky kraj";429;4230;144;4374;NA;98786;573;2021-12-16;-47389
2021-12-15;"Nitriansky kraj";639;5682;143;5825;NA;98786;782;2021-12-15;-47962
2021-12-14;"Nitriansky kraj";907;4720;200;4920;NA;98786;1107;2021-12-14;-48744
2021-12-13;"Nitriansky kraj";524;7388;291;7679;NA;98786;815;2021-12-13;-49851
2021-12-12;"Nitriansky kraj";289;3893;174;4067;NA;98786;463;2021-12-12;-50666
2021-12-11;"Nitriansky kraj";458;1754;121;1875;NA;98786;579;2021-12-11;-51129
2021-12-10;"Nitriansky kraj";591;4868;177;5045;NA;98786;768;2021-12-10;-51708
2021-12-09;"Nitriansky kraj";741;3428;202;3630;NA;98786;943;2021-12-09;-52476
2021-12-08;"Nitriansky kraj";954;5136;200;5336;NA;98786;1154;2021-12-08;-53419
2021-12-07;"Nitriansky kraj";900;4045;197;4242;NA;98786;1097;2021-12-07;-54573
2021-12-06;"Nitriansky kraj";699;8196;339;8535;NA;98786;1038;2021-12-06;-55670
2021-12-05;"Nitriansky kraj";337;4314;192;4506;NA;98786;529;2021-12-05;-56708
2021-12-04;"Nitriansky kraj";758;2045;180;2225;NA;98786;938;2021-12-04;-57237
2021-12-03;"Nitriansky kraj";920;5783;237;6020;NA;98786;1157;2021-12-03;-58175
2021-12-02;"Nitriansky kraj";1388;3898;267;4165;NA;98786;1655;2021-12-02;-59332
2021-12-01;"Nitriansky kraj";982;4107;261;4368;NA;98786;1243;2021-12-01;-60987
2021-11-30;"Nitriansky kraj";751;5575;241;5816;NA;98786;992;2021-11-30;-62230
2021-11-29;"Nitriansky kraj";665;10167;500;10667;NA;98786;1165;2021-11-29;-63222
2021-11-28;"Nitriansky kraj";357;6214;300;6514;NA;98786;657;2021-11-28;-64387
2021-11-27;"Nitriansky kraj";560;2879;281;3160;NA;98786;841;2021-11-27;-65044
2021-11-26;"Nitriansky kraj";824;5529;290;5819;NA;98786;1114;2021-11-26;-65885
2021-11-25;"Nitriansky kraj";847;4154;342;4496;NA;98786;1189;2021-11-25;-66999
2021-11-24;"Nitriansky kraj";875;4422;325;4747;NA;98786;1200;2021-11-24;-68188
2021-11-23;"Nitriansky kraj";1103;5148;353;5501;NA;98786;1456;2021-11-23;-69388
2021-11-22;"Nitriansky kraj";545;7126;465;7591;NA;98786;1010;2021-11-22;-70844
2021-11-21;"Nitriansky kraj";345;3410;314;3724;NA;98786;659;2021-11-21;-71854
2021-11-20;"Nitriansky kraj";579;1865;252;2117;NA;98786;831;2021-11-20;-72513
2021-11-19;"Nitriansky kraj";571;4256;349;4605;NA;98786;920;2021-11-19;-73344
2021-11-18;"Nitriansky kraj";677;4883;420;5303;NA;98786;1097;2021-11-18;-74264
2021-11-17;"Nitriansky kraj";479;1622;207;1829;NA;98786;686;2021-11-17;-75361
2021-11-16;"Nitriansky kraj";668;3882;266;4148;NA;98786;934;2021-11-16;-76047
2021-11-15;"Nitriansky kraj";556;6033;440;6473;NA;98786;996;2021-11-15;-76981
2021-11-14;"Nitriansky kraj";229;2796;259;3055;NA;98786;488;2021-11-14;-77977
2021-11-13;"Nitriansky kraj";387;1473;201;1674;NA;98786;588;2021-11-13;-78465
2021-11-12;"Nitriansky kraj";552;3096;270;3366;NA;98786;822;2021-11-12;-79053
2021-11-11;"Nitriansky kraj";539;3545;238;3783;NA;98786;777;2021-11-11;-79875
2021-11-10;"Nitriansky kraj";411;3494;234;3728;NA;98786;645;2021-11-10;-80652
2021-11-09;"Nitriansky kraj";413;3313;210;3523;NA;98786;623;2021-11-09;-81297
2021-11-08;"Nitriansky kraj";464;4936;331;5267;NA;98786;795;2021-11-08;-81920
2021-11-07;"Nitriansky kraj";209;2074;161;2235;NA;98786;370;2021-11-07;-82715
2021-11-06;"Nitriansky kraj";236;1407;114;1521;NA;98786;350;2021-11-06;-83085
2021-11-05;"Nitriansky kraj";407;2583;185;2768;NA;98786;592;2021-11-05;-83435
2021-11-04;"Nitriansky kraj";437;3083;168;3251;NA;98786;605;2021-11-04;-84027
2021-11-03;"Nitriansky kraj";525;2891;157;3048;NA;98786;682;2021-11-03;-84632
2021-11-02;"Nitriansky kraj";320;4279;239;4518;NA;98786;559;2021-11-02;-85314
2021-11-01;"Nitriansky kraj";136;712;61;773;NA;98786;197;2021-11-01;-85873
2021-10-31;"Nitriansky kraj";109;1234;114;1348;NA;98786;223;2021-10-31;-86070
2021-10-30;"Nitriansky kraj";202;1218;82;1300;NA;98786;284;2021-10-30;-86293
2021-10-29;"Nitriansky kraj";347;2481;120;2601;NA;98786;467;2021-10-29;-86577
2021-10-28;"Nitriansky kraj";281;2603;95;2698;NA;98786;376;2021-10-28;-87044
2021-10-27;"Nitriansky kraj";340;2923;112;3035;NA;98786;452;2021-10-27;-87420
2021-10-26;"Nitriansky kraj";297;2926;117;3043;NA;98786;414;2021-10-26;-87872
2021-10-25;"Nitriansky kraj";171;3599;124;3723;NA;98786;295;2021-10-25;-88286
2021-10-24;"Nitriansky kraj";58;1914;74;1988;NA;98786;132;2021-10-24;-88581
2021-10-23;"Nitriansky kraj";173;1815;77;1892;NA;98786;250;2021-10-23;-88713
2021-10-22;"Nitriansky kraj";202;2216;68;2284;NA;98786;270;2021-10-22;-88963
2021-10-21;"Nitriansky kraj";214;2793;65;2858;NA;98786;279;2021-10-21;-89233
2021-10-20;"Nitriansky kraj";218;2328;74;2402;NA;98786;292;2021-10-20;-89512
2021-10-19;"Nitriansky kraj";250;2929;65;2994;NA;98786;315;2021-10-19;-89804
2021-10-18;"Nitriansky kraj";81;3259;90;3349;NA;98786;171;2021-10-18;-90119
2021-10-17;"Nitriansky kraj";36;3010;92;3102;NA;98786;128;2021-10-17;-90290
2021-10-16;"Nitriansky kraj";37;1477;38;1515;NA;98786;75;2021-10-16;-90418
2021-10-15;"Nitriansky kraj";145;2653;34;2687;NA;98786;179;2021-10-15;-90493
2021-10-14;"Nitriansky kraj";95;2389;30;2419;NA;98786;125;2021-10-14;-90672
2021-10-13;"Nitriansky kraj";91;2248;36;2284;NA;98786;127;2021-10-13;-90797
2021-10-12;"Nitriansky kraj";119;2905;34;2939;NA;98786;153;2021-10-12;-90924
2021-10-11;"Nitriansky kraj";91;2703;42;2745;NA;98786;133;2021-10-11;-91077
2021-10-10;"Nitriansky kraj";33;1527;22;1549;NA;98786;55;2021-10-10;-91210
2021-10-09;"Nitriansky kraj";17;1395;17;1412;NA;98786;34;2021-10-09;-91265
2021-10-08;"Nitriansky kraj";61;3004;37;3041;NA;98786;98;2021-10-08;-91299
2021-10-07;"Nitriansky kraj";59;2829;30;2859;NA;98786;89;2021-10-07;-91397
2021-10-06;"Nitriansky kraj";66;2657;28;2685;NA;98786;94;2021-10-06;-91486
2021-10-05;"Nitriansky kraj";97;2536;32;2568;NA;98786;129;2021-10-05;-91580
2021-10-04;"Nitriansky kraj";56;3263;49;3312;NA;98786;105;2021-10-04;-91709
2021-10-03;"Nitriansky kraj";10;1591;24;1615;NA;98786;34;2021-10-03;-91814
2021-10-02;"Nitriansky kraj";46;1567;20;1587;NA;98786;66;2021-10-02;-91848
2021-10-01;"Nitriansky kraj";26;2860;34;2894;NA;98786;60;2021-10-01;-91914
2021-09-30;"Nitriansky kraj";66;2468;15;2483;NA;98786;81;2021-09-30;-91974
2021-09-29;"Nitriansky kraj";92;2266;16;2282;NA;98786;108;2021-09-29;-92055
2021-09-28;"Nitriansky kraj";86;2893;27;2920;NA;98786;113;2021-09-28;-92163
2021-09-27;"Nitriansky kraj";50;3633;41;3674;NA;98786;91;2021-09-27;-92276
2021-09-26;"Nitriansky kraj";12;1635;20;1655;NA;98786;32;2021-09-26;-92367
2021-09-25;"Nitriansky kraj";43;1456;20;1476;NA;98786;63;2021-09-25;-92399
2021-09-24;"Nitriansky kraj";35;2783;15;2798;NA;98786;50;2021-09-24;-92462
2021-09-23;"Nitriansky kraj";69;2503;20;2523;NA;98786;89;2021-09-23;-92512
2021-09-22;"Nitriansky kraj";68;2380;17;2397;NA;98786;85;2021-09-22;-92601
2021-09-21;"Nitriansky kraj";70;2684;30;2714;NA;98786;100;2021-09-21;-92686
2021-09-20;"Nitriansky kraj";41;2497;21;2518;NA;98786;62;2021-09-20;-92786
2021-09-19;"Nitriansky kraj";16;1553;20;1573;NA;98786;36;2021-09-19;-92848
2021-09-18;"Nitriansky kraj";42;1421;19;1440;NA;98786;61;2021-09-18;-92884
2021-09-17;"Nitriansky kraj";54;2757;30;2787;NA;98786;84;2021-09-17;-92945
2021-09-16;"Nitriansky kraj";55;2499;44;2543;NA;98786;99;2021-09-16;-93029
2021-09-15;"Nitriansky kraj";34;538;12;550;NA;98786;46;2021-09-15;-93128
2021-09-14;"Nitriansky kraj";52;1821;20;1841;NA;98786;72;2021-09-14;-93174
2021-09-13;"Nitriansky kraj";27;2373;27;2400;NA;98786;54;2021-09-13;-93246
2021-09-12;"Nitriansky kraj";4;1182;17;1199;NA;98786;21;2021-09-12;-93300
2021-09-11;"Nitriansky kraj";36;1181;8;1189;NA;98786;44;2021-09-11;-93321
2021-09-10;"Nitriansky kraj";25;2133;12;2145;NA;98786;37;2021-09-10;-93365
2021-09-09;"Nitriansky kraj";15;1611;20;1631;NA;98786;35;2021-09-09;-93402
2021-09-08;"Nitriansky kraj";30;1463;22;1485;NA;98786;52;2021-09-08;-93437
2021-09-07;"Nitriansky kraj";35;1460;9;1469;NA;98786;44;2021-09-07;-93489
2021-09-06;"Nitriansky kraj";19;1668;27;1695;NA;98786;46;2021-09-06;-93533
2021-09-05;"Nitriansky kraj";10;1007;8;1015;NA;98786;18;2021-09-05;-93579
2021-09-04;"Nitriansky kraj";18;1119;10;1129;NA;98786;28;2021-09-04;-93597
2021-09-03;"Nitriansky kraj";20;1743;17;1760;NA;98786;37;2021-09-03;-93625
2021-09-02;"Nitriansky kraj";16;1389;14;1403;NA;98786;30;2021-09-02;-93662
2021-09-01;"Nitriansky kraj";9;337;2;339;NA;98786;11;2021-09-01;-93692
2021-08-31;"Nitriansky kraj";10;1360;6;1366;NA;98786;16;2021-08-31;-93703
2021-08-30;"Nitriansky kraj";8;1381;10;1391;NA;98786;18;2021-08-30;-93719
2021-08-29;"Nitriansky kraj";2;450;1;451;NA;98786;3;2021-08-29;-93737
2021-08-28;"Nitriansky kraj";5;1071;3;1074;NA;98786;8;2021-08-28;-93740
2021-08-27;"Nitriansky kraj";7;1804;4;1808;NA;98786;11;2021-08-27;-93748
2021-08-26;"Nitriansky kraj";2;1255;6;1261;NA;98786;8;2021-08-26;-93759
2021-08-25;"Nitriansky kraj";15;1087;3;1090;NA;98786;18;2021-08-25;-93767
2021-08-24;"Nitriansky kraj";6;990;2;992;NA;98786;8;2021-08-24;-93785
2021-08-23;"Nitriansky kraj";13;1271;4;1275;NA;98786;17;2021-08-23;-93793
2021-08-22;"Nitriansky kraj";0;1167;3;1170;NA;98786;3;2021-08-22;-93810
2021-08-21;"Nitriansky kraj";1;853;2;855;NA;98786;3;2021-08-21;-93813
2021-08-20;"Nitriansky kraj";8;1580;5;1585;NA;98786;13;2021-08-20;-93816
2021-08-19;"Nitriansky kraj";11;1167;4;1171;NA;98786;15;2021-08-19;-93829
2021-08-18;"Nitriansky kraj";8;1180;7;1187;NA;98786;15;2021-08-18;-93844
2021-08-17;"Nitriansky kraj";4;1035;3;1038;NA;98786;7;2021-08-17;-93859
2021-08-16;"Nitriansky kraj";7;1129;4;1133;NA;98786;11;2021-08-16;-93866
2021-08-15;"Nitriansky kraj";2;662;1;663;NA;98786;3;2021-08-15;-93877
2021-08-14;"Nitriansky kraj";1;878;5;883;NA;98786;6;2021-08-14;-93880
2021-08-13;"Nitriansky kraj";0;957;1;958;NA;98786;1;2021-08-13;-93886
2021-08-12;"Nitriansky kraj";5;765;0;765;NA;98786;5;2021-08-12;-93887
2021-08-11;"Nitriansky kraj";3;527;1;528;NA;98786;4;2021-08-11;-93892
2021-08-10;"Nitriansky kraj";3;570;1;571;NA;98786;4;2021-08-10;-93896
2021-08-09;"Nitriansky kraj";3;992;1;993;NA;98786;4;2021-08-09;-93900
2021-08-08;"Nitriansky kraj";0;668;1;669;NA;98786;1;2021-08-08;-93904
2021-08-07;"Nitriansky kraj";0;557;1;558;NA;98786;1;2021-08-07;-93905
2021-08-06;"Nitriansky kraj";5;799;0;799;NA;98786;5;2021-08-06;-93906
2021-08-05;"Nitriansky kraj";6;612;0;612;NA;98786;6;2021-08-05;-93911
2021-08-04;"Nitriansky kraj";1;497;2;499;NA;98786;3;2021-08-04;-93917
2021-08-03;"Nitriansky kraj";5;1455;0;1455;NA;98786;5;2021-08-03;-93920
2021-08-02;"Nitriansky kraj";1;683;4;687;NA;98786;5;2021-08-02;-93925
2021-08-01;"Nitriansky kraj";1;606;0;606;NA;98786;1;2021-08-01;-93930
2021-07-31;"Nitriansky kraj";1;514;1;515;NA;98786;2;2021-07-31;-93931
2021-07-30;"Nitriansky kraj";2;827;0;827;NA;98786;2;2021-07-30;-93933
2021-07-29;"Nitriansky kraj";3;720;2;722;NA;98786;5;2021-07-29;-93935
2021-07-28;"Nitriansky kraj";4;598;0;598;NA;98786;4;2021-07-28;-93940
2021-07-27;"Nitriansky kraj";12;602;1;603;NA;98786;13;2021-07-27;-93944
2021-07-26;"Nitriansky kraj";7;970;1;971;NA;98786;8;2021-07-26;-93957
2021-07-25;"Nitriansky kraj";1;654;1;655;NA;98786;2;2021-07-25;-93965
2021-07-24;"Nitriansky kraj";0;620;0;620;NA;98786;0;2021-07-24;-93967
2021-07-23;"Nitriansky kraj";3;851;1;852;NA;98786;4;2021-07-23;-93967
2021-07-22;"Nitriansky kraj";5;689;0;689;NA;98786;5;2021-07-22;-93971
2021-07-21;"Nitriansky kraj";6;650;2;652;NA;98786;8;2021-07-21;-93976
2021-07-20;"Nitriansky kraj";1;527;1;528;NA;98786;2;2021-07-20;-93984
2021-07-19;"Nitriansky kraj";2;965;0;965;NA;98786;2;2021-07-19;-93986
2021-07-18;"Nitriansky kraj";1;747;0;747;NA;98786;1;2021-07-18;-93988
2021-07-17;"Nitriansky kraj";5;612;0;612;NA;98786;5;2021-07-17;-93989
2021-07-16;"Nitriansky kraj";2;876;0;876;NA;98786;2;2021-07-16;-93994
2021-07-15;"Nitriansky kraj";11;708;0;708;NA;98786;11;2021-07-15;-93996
2021-07-14;"Nitriansky kraj";4;646;0;646;NA;98786;4;2021-07-14;-94007
2021-07-13;"Nitriansky kraj";2;697;2;699;NA;98786;4;2021-07-13;-94011
2021-07-12;"Nitriansky kraj";1;819;0;819;NA;98786;1;2021-07-12;-94015
2021-07-11;"Nitriansky kraj";1;961;0;961;NA;98786;1;2021-07-11;-94016
2021-07-10;"Nitriansky kraj";1;630;0;630;NA;98786;1;2021-07-10;-94017
2021-07-09;"Nitriansky kraj";3;1000;0;1000;NA;98786;3;2021-07-09;-94018
2021-07-08;"Nitriansky kraj";0;683;0;683;NA;98786;0;2021-07-08;-94021
2021-07-07;"Nitriansky kraj";2;935;2;937;NA;98786;4;2021-07-07;-94021
2021-07-06;"Nitriansky kraj";1;1269;1;1270;NA;98786;2;2021-07-06;-94025
2021-07-05;"Nitriansky kraj";1;507;0;507;NA;98786;1;2021-07-05;-94027
2021-07-04;"Nitriansky kraj";0;821;1;822;NA;98786;1;2021-07-04;-94028
2021-07-03;"Nitriansky kraj";0;611;0;611;NA;98786;0;2021-07-03;-94029
2021-07-02;"Nitriansky kraj";0;1259;0;1259;NA;98786;0;2021-07-02;-94029
2021-07-01;"Nitriansky kraj";0;369;1;370;NA;98786;1;2021-07-01;-94029
2021-06-30;"Nitriansky kraj";1;6777;2;6779;NA;98786;3;2021-06-30;-94030
2021-06-29;"Nitriansky kraj";1;3536;0;3536;NA;98786;1;2021-06-29;-94033
2021-06-28;"Nitriansky kraj";3;4393;0;4393;NA;98786;3;2021-06-28;-94034
2021-06-27;"Nitriansky kraj";0;3263;0;3263;NA;98786;0;2021-06-27;-94037
2021-06-26;"Nitriansky kraj";1;4979;3;4982;NA;98786;4;2021-06-26;-94037
2021-06-25;"Nitriansky kraj";8;5182;1;5183;NA;98786;9;2021-06-25;-94041
2021-06-24;"Nitriansky kraj";1;3354;0;3354;NA;98786;1;2021-06-24;-94050
2021-06-23;"Nitriansky kraj";1;3033;0;3033;NA;98786;1;2021-06-23;-94051
2021-06-22;"Nitriansky kraj";1;3240;3;3243;NA;98786;4;2021-06-22;-94052
2021-06-21;"Nitriansky kraj";8;5362;8;5370;NA;98786;16;2021-06-21;-94056
2021-06-20;"Nitriansky kraj";0;4437;6;4443;NA;98786;6;2021-06-20;-94072
2021-06-19;"Nitriansky kraj";0;5983;4;5987;NA;98786;4;2021-06-19;-94078
2021-06-18;"Nitriansky kraj";4;6453;3;6456;NA;98786;7;2021-06-18;-94082
2021-06-17;"Nitriansky kraj";5;4152;1;4153;NA;98786;6;2021-06-17;-94089
2021-06-16;"Nitriansky kraj";4;3694;3;3697;NA;98786;7;2021-06-16;-94095
2021-06-15;"Nitriansky kraj";1;3995;0;3995;NA;98786;1;2021-06-15;-94102
2021-06-14;"Nitriansky kraj";0;5875;3;5878;NA;98786;3;2021-06-14;-94103
2021-06-13;"Nitriansky kraj";0;6073;3;6076;NA;98786;3;2021-06-13;-94106
2021-06-12;"Nitriansky kraj";1;8293;1;8294;NA;98786;2;2021-06-12;-94109
2021-06-11;"Nitriansky kraj";3;6891;4;6895;NA;98786;7;2021-06-11;-94111
2021-06-10;"Nitriansky kraj";7;4539;1;4540;NA;98786;8;2021-06-10;-94118
2021-06-09;"Nitriansky kraj";2;4706;2;4708;NA;98786;4;2021-06-09;-94126
2021-06-08;"Nitriansky kraj";8;4239;3;4242;NA;98786;11;2021-06-08;-94130
2021-06-07;"Nitriansky kraj";6;5841;8;5849;NA;98786;14;2021-06-07;-94141
2021-06-06;"Nitriansky kraj";0;6981;4;6985;NA;98786;4;2021-06-06;-94155
2021-06-05;"Nitriansky kraj";6;9089;9;9098;NA;98786;15;2021-06-05;-94159
2021-06-04;"Nitriansky kraj";9;7639;5;7644;NA;98786;14;2021-06-04;-94174
2021-06-03;"Nitriansky kraj";2;5064;6;5070;NA;98786;8;2021-06-03;-94188
2021-06-02;"Nitriansky kraj";11;5119;11;5130;NA;98786;22;2021-06-02;-94196
2021-06-01;"Nitriansky kraj";3;4862;2;4864;NA;98786;5;2021-06-01;-94218
2021-05-31;"Nitriansky kraj";8;8933;8;8941;NA;98786;16;2021-05-31;-94223
2021-05-30;"Nitriansky kraj";1;9067;8;9075;NA;98786;9;2021-05-30;-94239
2021-05-29;"Nitriansky kraj";2;13610;7;13617;NA;98786;9;2021-05-29;-94248
2021-05-28;"Nitriansky kraj";10;8872;6;8878;NA;98786;16;2021-05-28;-94257
2021-05-27;"Nitriansky kraj";4;6164;5;6169;NA;98786;9;2021-05-27;-94273
2021-05-26;"Nitriansky kraj";11;8509;10;8519;NA;98786;21;2021-05-26;-94282
2021-05-25;"Nitriansky kraj";15;7350;8;7358;NA;98786;23;2021-05-25;-94303
2021-05-24;"Nitriansky kraj";14;9816;17;9833;NA;98786;31;2021-05-24;-94326
2021-05-23;"Nitriansky kraj";1;9456;13;9469;NA;98786;14;2021-05-23;-94357
2021-05-22;"Nitriansky kraj";7;16939;11;16950;NA;98786;18;2021-05-22;-94371
2021-05-21;"Nitriansky kraj";18;10632;15;10647;NA;98786;33;2021-05-21;-94389
2021-05-20;"Nitriansky kraj";8;7185;7;7192;NA;98786;15;2021-05-20;-94422
2021-05-19;"Nitriansky kraj";20;6787;14;6801;NA;98786;34;2021-05-19;-94437
2021-05-18;"Nitriansky kraj";23;7797;18;7815;NA;98786;41;2021-05-18;-94471
2021-05-17;"Nitriansky kraj";22;9774;20;9794;NA;98786;42;2021-05-17;-94512
2021-05-16;"Nitriansky kraj";4;13830;15;13845;NA;98786;19;2021-05-16;-94554
2021-05-15;"Nitriansky kraj";5;25389;23;25412;NA;98786;28;2021-05-15;-94573
2021-05-14;"Nitriansky kraj";18;13385;23;13408;NA;98786;41;2021-05-14;-94601
2021-05-13;"Nitriansky kraj";24;8289;19;8308;NA;98786;43;2021-05-13;-94642
2021-05-12;"Nitriansky kraj";10;7682;26;7708;NA;98786;36;2021-05-12;-94685
2021-05-11;"Nitriansky kraj";36;8169;13;8182;NA;98786;49;2021-05-11;-94721
2021-05-10;"Nitriansky kraj";16;13800;42;13842;NA;98786;58;2021-05-10;-94770
2021-05-09;"Nitriansky kraj";8;21879;35;21914;NA;98786;43;2021-05-09;-94828
2021-05-08;"Nitriansky kraj";0;24318;29;24347;NA;98786;29;2021-05-08;-94871
2021-05-07;"Nitriansky kraj";32;14915;20;14935;NA;98786;52;2021-05-07;-94900
2021-05-06;"Nitriansky kraj";30;9463;20;9483;NA;98786;50;2021-05-06;-94952
2021-05-05;"Nitriansky kraj";19;8527;23;8550;NA;98786;42;2021-05-05;-95002
2021-05-04;"Nitriansky kraj";46;9385;27;9412;NA;98786;73;2021-05-04;-95044
2021-05-03;"Nitriansky kraj";32;14490;44;14534;NA;98786;76;2021-05-03;-95117
2021-05-02;"Nitriansky kraj";4;31751;46;31797;NA;98786;50;2021-05-02;-95193
2021-05-01;"Nitriansky kraj";23;60451;43;60494;NA;98786;66;2021-05-01;-95243
2021-04-30;"Nitriansky kraj";28;31803;53;31856;NA;98786;81;2021-04-30;-95309
2021-04-29;"Nitriansky kraj";27;14265;34;14299;NA;98786;61;2021-04-29;-95390
2021-04-28;"Nitriansky kraj";36;14716;45;14761;NA;98786;81;2021-04-28;-95451
2021-04-27;"Nitriansky kraj";51;13154;35;13189;NA;98786;86;2021-04-27;-95532
2021-04-26;"Nitriansky kraj";38;21029;44;21073;NA;98786;82;2021-04-26;-95618
2021-04-25;"Nitriansky kraj";7;44312;46;44358;NA;98786;53;2021-04-25;-95700
2021-04-24;"Nitriansky kraj";23;93455;72;93527;NA;98786;95;2021-04-24;-95753
2021-04-23;"Nitriansky kraj";54;35145;51;35196;NA;98786;105;2021-04-23;-95848
2021-04-22;"Nitriansky kraj";32;15435;44;15479;NA;98786;76;2021-04-22;-95953
2021-04-21;"Nitriansky kraj";38;14228;45;14273;NA;98786;83;2021-04-21;-96029
2021-04-20;"Nitriansky kraj";67;16058;51;16109;NA;98786;118;2021-04-20;-96112
2021-04-19;"Nitriansky kraj";35;24819;59;24878;NA;98786;94;2021-04-19;-96230
2021-04-18;"Nitriansky kraj";0;39569;27;39596;NA;98786;27;2021-04-18;-96324
2021-04-17;"Nitriansky kraj";34;92102;82;92184;NA;98786;116;2021-04-17;-96351
2021-04-16;"Nitriansky kraj";46;32348;37;32385;NA;98786;83;2021-04-16;-96467
2021-04-15;"Nitriansky kraj";75;16215;52;16267;NA;98786;127;2021-04-15;-96550
2021-04-14;"Nitriansky kraj";43;15303;42;15345;NA;98786;85;2021-04-14;-96677
2021-04-13;"Nitriansky kraj";110;15104;44;15148;NA;98786;154;2021-04-13;-96762
2021-04-12;"Nitriansky kraj";29;22817;50;22867;NA;98786;79;2021-04-12;-96916
2021-04-11;"Nitriansky kraj";1;37537;31;37568;NA;98786;32;2021-04-11;-96995
2021-04-10;"Nitriansky kraj";35;95851;115;95966;NA;98786;150;2021-04-10;-97027
2021-04-09;"Nitriansky kraj";69;30669;58;30727;NA;98786;127;2021-04-09;-97177
2021-04-08;"Nitriansky kraj";71;15361;36;15397;NA;98786;107;2021-04-08;-97304
2021-04-07;"Nitriansky kraj";64;18541;47;18588;NA;98786;111;2021-04-07;-97411
2021-04-06;"Nitriansky kraj";65;33218;112;33330;NA;98786;177;2021-04-06;-97522
2021-04-05;"Nitriansky kraj";37;12673;48;12721;NA;98786;85;2021-04-05;-97699
2021-04-04;"Nitriansky kraj";5;17887;35;17922;NA;98786;40;2021-04-04;-97784
2021-04-03;"Nitriansky kraj";26;85465;153;85618;NA;98786;179;2021-04-03;-97824
2021-04-02;"Nitriansky kraj";32;18743;46;18789;NA;98786;78;2021-04-02;-98003
2021-04-01;"Nitriansky kraj";63;24640;83;24723;NA;98786;146;2021-04-01;-98081
2021-03-31;"Nitriansky kraj";73;21752;94;21846;NA;98786;167;2021-03-31;-98227
2021-03-30;"Nitriansky kraj";125;17122;83;17205;NA;98786;208;2021-03-30;-98394
2021-03-29;"Nitriansky kraj";81;25139;100;25239;NA;98786;181;2021-03-29;-98602
2021-03-28;"Nitriansky kraj";6;45581;106;45687;NA;98786;112;2021-03-28;-98783
2021-03-27;"Nitriansky kraj";39;104104;174;104278;NA;98786;213;2021-03-27;-98895
2021-03-26;"Nitriansky kraj";90;40444;115;40559;NA;98786;205;2021-03-26;-99108
2021-03-25;"Nitriansky kraj";95;19219;94;19313;NA;98786;189;2021-03-25;-99313
2021-03-24;"Nitriansky kraj";90;14787;91;14878;NA;98786;181;2021-03-24;-99502
2021-03-23;"Nitriansky kraj";167;16753;66;16819;NA;98786;233;2021-03-23;-99683
2021-03-22;"Nitriansky kraj";101;24886;125;25011;NA;98786;226;2021-03-22;-99916
2021-03-21;"Nitriansky kraj";27;42773;99;42872;NA;98786;126;2021-03-21;-100142
2021-03-20;"Nitriansky kraj";36;100640;207;100847;NA;98786;243;2021-03-20;-100268
2021-03-19;"Nitriansky kraj";76;37312;102;37414;NA;98786;178;2021-03-19;-100511
2021-03-18;"Nitriansky kraj";103;20051;113;20164;NA;98786;216;2021-03-18;-100689
2021-03-17;"Nitriansky kraj";87;15839;127;15966;NA;98786;214;2021-03-17;-100905
2021-03-16;"Nitriansky kraj";172;18085;121;18206;NA;98786;293;2021-03-16;-101119
2021-03-15;"Nitriansky kraj";130;24481;165;24646;NA;98786;295;2021-03-15;-101412
2021-03-14;"Nitriansky kraj";3;45770;107;45877;NA;98786;110;2021-03-14;-101707
2021-03-13;"Nitriansky kraj";65;112573;242;112815;NA;98786;307;2021-03-13;-101817
2021-03-12;"Nitriansky kraj";127;40777;159;40936;NA;98786;286;2021-03-12;-102124
2021-03-11;"Nitriansky kraj";131;18686;130;18816;NA;98786;261;2021-03-11;-102410
2021-03-10;"Nitriansky kraj";96;17422;143;17565;NA;98786;239;2021-03-10;-102671
2021-03-09;"Nitriansky kraj";260;17635;149;17784;NA;98786;409;2021-03-09;-102910
2021-03-08;"Nitriansky kraj";145;27214;172;27386;NA;98786;317;2021-03-08;-103319
2021-03-07;"Nitriansky kraj";48;46867;185;47052;NA;98786;233;2021-03-07;-103636
2021-03-06;"Nitriansky kraj";86;112027;327;112354;NA;98786;413;2021-03-06;-103869
2021-03-05;"Nitriansky kraj";133;39068;200;39268;NA;98786;333;2021-03-05;-104282
2021-03-04;"Nitriansky kraj";176;18340;173;18513;NA;98786;349;2021-03-04;-104615
2021-03-03;"Nitriansky kraj";172;17210;177;17387;NA;98786;349;2021-03-03;-104964
2021-03-02;"Nitriansky kraj";274;21003;366;21369;NA;98786;640;2021-03-02;-105313
2021-03-01;"Nitriansky kraj";133;27881;279;28160;NA;98786;412;2021-03-01;-105953
2021-02-28;"Nitriansky kraj";80;40866;218;41084;NA;98786;298;2021-02-28;-106365
2021-02-27;"Nitriansky kraj";101;106352;496;106848;NA;98786;597;2021-02-27;-106663
2021-02-26;"Nitriansky kraj";109;36788;308;37096;NA;98786;417;2021-02-26;-107260
2021-02-25;"Nitriansky kraj";188;15243;212;15455;NA;98786;400;2021-02-25;-107677
2021-02-24;"Nitriansky kraj";125;13833;260;14093;NA;98786;385;2021-02-24;-108077
2021-02-23;"Nitriansky kraj";273;15402;273;15675;NA;98786;546;2021-02-23;-108462
2021-02-22;"Nitriansky kraj";154;26478;330;26808;NA;98786;484;2021-02-22;-109008
2021-02-21;"Nitriansky kraj";22;43664;320;43984;NA;98786;342;2021-02-21;-109492
2021-02-20;"Nitriansky kraj";128;109038;586;109624;NA;98786;714;2021-02-20;-109834
2021-02-19;"Nitriansky kraj";173;36849;328;37177;NA;98786;501;2021-02-19;-110548
2021-02-18;"Nitriansky kraj";202;17045;275;17320;NA;98786;477;2021-02-18;-111049
2021-02-17;"Nitriansky kraj";198;12080;310;12390;NA;98786;508;2021-02-17;-111526
2021-02-16;"Nitriansky kraj";284;16066;288;16354;NA;98786;572;2021-02-16;-112034
2021-02-15;"Nitriansky kraj";122;28636;474;29110;NA;98786;596;2021-02-15;-112606
2021-02-14;"Nitriansky kraj";8;49392;315;49707;NA;98786;323;2021-02-14;-113202
2021-02-13;"Nitriansky kraj";127;110294;690;110984;NA;98786;817;2021-02-13;-113525
2021-02-12;"Nitriansky kraj";162;33405;407;33812;NA;98786;569;2021-02-12;-114342
2021-02-11;"Nitriansky kraj";195;12406;270;12676;NA;98786;465;2021-02-11;-114911
2021-02-10;"Nitriansky kraj";186;17770;644;18414;NA;98786;830;2021-02-10;-115376
2021-02-09;"Nitriansky kraj";260;18530;385;18915;NA;98786;645;2021-02-09;-116206
2021-02-08;"Nitriansky kraj";177;37530;569;38099;NA;98786;746;2021-02-08;-116851
2021-02-07;"Nitriansky kraj";20;52307;513;52820;NA;98786;533;2021-02-07;-117597
2021-02-06;"Nitriansky kraj";129;101439;764;102203;NA;98786;893;2021-02-06;-118130
2021-02-05;"Nitriansky kraj";244;26137;491;26628;NA;98786;735;2021-02-05;-119023
2021-02-04;"Nitriansky kraj";308;15681;512;16193;NA;98786;820;2021-02-04;-119758
2021-02-03;"Nitriansky kraj";191;13459;382;13841;NA;98786;573;2021-02-03;-120578
2021-02-02;"Nitriansky kraj";327;17880;382;18262;NA;98786;709;2021-02-02;-121151
2021-02-01;"Nitriansky kraj";221;24002;460;24462;NA;98786;681;2021-02-01;-121860
2021-01-31;"Nitriansky kraj";9;46215;507;46722;NA;98786;516;2021-01-31;-122541
2021-01-30;"Nitriansky kraj";152;99241;1090;100331;NA;98786;1242;2021-01-30;-123057
2021-01-29;"Nitriansky kraj";302;22461;477;22938;NA;98786;779;2021-01-29;-124299
2021-01-28;"Nitriansky kraj";269;11370;398;11768;NA;98786;667;2021-01-28;-125078
2021-01-27;"Nitriansky kraj";235;6758;299;7057;NA;98786;534;2021-01-27;-125745
2021-01-26;"Nitriansky kraj";345;16015;454;16469;NA;98786;799;2021-01-26;-126279
2021-01-25;"Nitriansky kraj";201;21909;434;22343;NA;98786;635;2021-01-25;-127078
2021-01-24;"Nitriansky kraj";12;79041;897;79938;NA;98786;909;2021-01-24;-127713
2021-01-23;"Nitriansky kraj";277;97845;1446;99291;NA;98786;1723;2021-01-23;-128622
2021-01-22;"Nitriansky kraj";139;35924;619;36543;NA;98786;758;2021-01-22;-130345
2021-01-21;"Nitriansky kraj";305;14649;412;15061;NA;98786;717;2021-01-21;-131103
2021-01-20;"Nitriansky kraj";326;11991;625;12616;NA;98786;951;2021-01-20;-131820
2021-01-19;"Nitriansky kraj";344;11015;633;11648;NA;98786;977;2021-01-19;-132771
2021-01-18;"Nitriansky kraj";367;8901;519;9420;NA;98786;886;2021-01-18;-133748
2021-01-17;"Nitriansky kraj";97;15061;275;15336;NA;98786;372;2021-01-17;-134634
2021-01-16;"Nitriansky kraj";64;36838;679;37517;NA;98786;743;2021-01-16;-135006
2021-01-15;"Nitriansky kraj";373;15940;474;16414;NA;98786;847;2021-01-15;-135749
2021-01-14;"Nitriansky kraj";627;10577;452;11029;NA;98786;1079;2021-01-14;-136596
2021-01-13;"Nitriansky kraj";663;9234;484;9718;NA;98786;1147;2021-01-13;-137675
2021-01-12;"Nitriansky kraj";642;8805;545;9350;NA;98786;1187;2021-01-12;-138822
2021-01-11;"Nitriansky kraj";422;8347;513;8860;NA;98786;935;2021-01-11;-140009
2021-01-10;"Nitriansky kraj";44;19841;730;20571;NA;98786;774;2021-01-10;-140944
2021-01-09;"Nitriansky kraj";532;36823;1071;37894;NA;98786;1603;2021-01-09;-141718
2021-01-08;"Nitriansky kraj";817;14001;691;14692;NA;98786;1508;2021-01-08;-143321
2021-01-07;"Nitriansky kraj";438;10121;795;10916;NA;98786;1233;2021-01-07;-144829
2021-01-06;"Nitriansky kraj";259;3192;197;3389;NA;98786;456;2021-01-06;-146062
2021-01-05;"Nitriansky kraj";732;8918;1208;10126;NA;98786;1940;2021-01-05;-146518
2021-01-04;"Nitriansky kraj";362;8409;1287;9696;NA;98786;1649;2021-01-04;-148458
2021-01-03;"Nitriansky kraj";42;84;20;104;NA;98786;62;2021-01-03;-150107
2021-01-02;"Nitriansky kraj";249;1090;26;1116;NA;98786;275;2021-01-02;-150169
2021-01-01;"Nitriansky kraj";119;781;95;876;NA;98786;214;2021-01-01;-150444
2020-12-31;"Nitriansky kraj";786;7646;962;8608;NA;98786;1748;2020-12-31;-150658
2020-12-30;"Nitriansky kraj";1094;9619;1165;10784;NA;98786;2259;2020-12-30;-152406
2020-12-29;"Nitriansky kraj";607;8028;1245;9273;NA;98786;1852;2020-12-29;-154665
2020-12-28;"Nitriansky kraj";83;6804;1220;8024;NA;98786;1303;2020-12-28;-156517
2020-12-27;"Nitriansky kraj";22;60;8;68;NA;98786;30;2020-12-27;-157820
2020-12-26;"Nitriansky kraj";54;297;56;353;NA;98786;110;2020-12-26;-157850
2020-12-25;"Nitriansky kraj";35;60;11;71;NA;98786;46;2020-12-25;-157960
2020-12-24;"Nitriansky kraj";514;1861;176;2037;NA;98786;690;2020-12-24;-158006
2020-12-23;"Nitriansky kraj";349;14679;782;15461;NA;98786;1131;2020-12-23;-158696
2020-12-22;"Nitriansky kraj";673;10623;949;11572;NA;98786;1622;2020-12-22;-159827
2020-12-21;"Nitriansky kraj";128;7587;931;8518;NA;98786;1059;2020-12-21;-161449
2020-12-20;"Nitriansky kraj";77;50;10;60;NA;98786;87;2020-12-20;-162508
2020-12-19;"Nitriansky kraj";262;2259;159;2418;NA;98786;421;2020-12-19;-162595
2020-12-18;"Nitriansky kraj";512;7946;518;8464;NA;98786;1030;2020-12-18;-163016
2020-12-17;"Nitriansky kraj";586;6519;486;7005;NA;98786;1072;2020-12-17;-164046
2020-12-16;"Nitriansky kraj";357;8097;500;8597;NA;98786;857;2020-12-16;-165118
2020-12-15;"Nitriansky kraj";461;9084;750;9834;NA;98786;1211;2020-12-15;-165975
2020-12-14;"Nitriansky kraj";217;7816;797;8613;NA;98786;1014;2020-12-14;-167186
2020-12-13;"Nitriansky kraj";12;69;6;75;NA;98786;18;2020-12-13;-168200
2020-12-12;"Nitriansky kraj";341;1832;125;1957;NA;98786;466;2020-12-12;-168218
2020-12-11;"Nitriansky kraj";409;5117;384;5501;NA;98786;793;2020-12-11;-168684
2020-12-10;"Nitriansky kraj";360;5239;345;5584;NA;98786;705;2020-12-10;-169477
2020-12-09;"Nitriansky kraj";362;5494;529;6023;NA;98786;891;2020-12-09;-170182
2020-12-08;"Nitriansky kraj";340;8168;548;8716;NA;98786;888;2020-12-08;-171073
2020-12-07;"Nitriansky kraj";139;6243;573;6816;NA;98786;712;2020-12-07;-171961
2020-12-06;"Nitriansky kraj";15;89;4;93;NA;98786;19;2020-12-06;-172673
2020-12-05;"Nitriansky kraj";136;1388;19;1407;NA;98786;155;2020-12-05;-172692
2020-12-04;"Nitriansky kraj";232;2884;74;2958;NA;98786;306;2020-12-04;-172847
2020-12-03;"Nitriansky kraj";248;2471;110;2581;NA;98786;358;2020-12-03;-173153
2020-12-02;"Nitriansky kraj";252;2580;151;2731;NA;98786;403;2020-12-02;-173511
2020-12-01;"Nitriansky kraj";331;2891;131;3022;NA;98786;462;2020-12-01;-173914
2020-11-30;"Nitriansky kraj";91;4228;188;4416;NA;98786;279;2020-11-30;-174376
2020-11-29;"Nitriansky kraj";3;634;42;676;NA;98786;45;2020-11-29;-174655
2020-11-28;"Nitriansky kraj";135;892;31;923;NA;98786;166;2020-11-28;-174700
2020-11-27;"Nitriansky kraj";177;2069;73;2142;NA;98786;250;2020-11-27;-174866
2020-11-26;"Nitriansky kraj";191;2813;80;2893;NA;98786;271;2020-11-26;-175116
2020-11-25;"Nitriansky kraj";325;2478;91;2569;NA;98786;416;2020-11-25;-175387
2020-11-24;"Nitriansky kraj";147;1641;64;1705;NA;98786;211;2020-11-24;-175803
2020-11-23;"Nitriansky kraj";102;9891;212;10103;NA;98786;314;2020-11-23;-176014
2020-11-22;"Nitriansky kraj";7;1176;25;1201;NA;98786;32;2020-11-22;-176328
2020-11-21;"Nitriansky kraj";86;1083;38;1121;NA;98786;124;2020-11-21;-176360
2020-11-20;"Nitriansky kraj";264;4180;103;4283;NA;98786;367;2020-11-20;-176484
2020-11-19;"Nitriansky kraj";185;3065;134;3199;NA;98786;319;2020-11-19;-176851
2020-11-18;"Nitriansky kraj";188;2214;79;2293;NA;98786;267;2020-11-18;-177170
2020-11-17;"Nitriansky kraj";178;596;29;625;NA;98786;207;2020-11-17;-177437
2020-11-16;"Nitriansky kraj";139;1877;75;1952;NA;98786;214;2020-11-16;-177644
2020-11-15;"Nitriansky kraj";14;180;5;185;NA;98786;19;2020-11-15;-177858
2020-11-14;"Nitriansky kraj";114;1131;32;1163;NA;98786;146;2020-11-14;-177877
2020-11-13;"Nitriansky kraj";210;936;46;982;NA;98786;256;2020-11-13;-178023
2020-11-12;"Nitriansky kraj";256;1195;35;1230;NA;98786;291;2020-11-12;-178279
2020-11-11;"Nitriansky kraj";279;1247;22;1269;NA;98786;301;2020-11-11;-178570
2020-11-10;"Nitriansky kraj";192;2623;39;2662;NA;98786;231;2020-11-10;-178871
2020-11-09;"Nitriansky kraj";128;3136;43;3179;NA;98786;171;2020-11-09;-179102
2020-11-08;"Nitriansky kraj";43;1462;32;1494;NA;98786;75;2020-11-08;-179273
2020-11-07;"Nitriansky kraj";130;1046;4;1050;NA;98786;134;2020-11-07;-179348
2020-11-06;"Nitriansky kraj";210;2264;32;2296;NA;98786;242;2020-11-06;-179482
2020-11-05;"Nitriansky kraj";178;313;14;327;NA;98786;192;2020-11-05;-179724
2020-11-04;"Nitriansky kraj";211;297;16;313;NA;98786;227;2020-11-04;-179916
2020-11-03;"Nitriansky kraj";216;435;25;460;NA;98786;241;2020-11-03;-180143
2020-11-02;"Nitriansky kraj";171;4208;46;4254;NA;98786;217;2020-11-02;-180384
2020-11-01;"Nitriansky kraj";130;2546;27;2573;NA;98786;157;2020-11-01;-180601
2020-10-31;"Nitriansky kraj";261;10466;134;10600;NA;98786;395;2020-10-31;-180758
2020-10-30;"Nitriansky kraj";204;2593;42;2635;NA;98786;246;2020-10-30;-181153
2020-10-29;"Nitriansky kraj";293;841;39;880;NA;98786;332;2020-10-29;-181399
2020-10-28;"Nitriansky kraj";216;608;59;667;NA;98786;275;2020-10-28;-181731
2020-10-27;"Nitriansky kraj";296;550;47;597;NA;98786;343;2020-10-27;-182006
2020-10-26;"Nitriansky kraj";69;633;56;689;NA;98786;125;2020-10-26;-182349
2020-10-25;"Nitriansky kraj";50;62;8;70;NA;98786;58;2020-10-25;-182474
2020-10-24;"Nitriansky kraj";169;237;11;248;NA;98786;180;2020-10-24;-182532
2020-10-23;"Nitriansky kraj";282;762;41;803;NA;98786;323;2020-10-23;-182712
2020-10-22;"Nitriansky kraj";137;444;39;483;NA;98786;176;2020-10-22;-183035
2020-10-21;"Nitriansky kraj";146;208;3;211;NA;98786;149;2020-10-21;-183211
2020-10-20;"Nitriansky kraj";197;78;6;84;NA;98786;203;2020-10-20;-183360
2020-10-19;"Nitriansky kraj";148;79;1;80;NA;98786;149;2020-10-19;-183563
2020-10-18;"Nitriansky kraj";22;0;0;0;NA;98786;22;2020-10-18;-183712
2020-10-17;"Nitriansky kraj";67;0;0;0;NA;98786;67;2020-10-17;-183734
2020-10-16;"Nitriansky kraj";133;28;3;31;NA;98786;136;2020-10-16;-183801
2020-10-15;"Nitriansky kraj";106;31;2;33;NA;98786;108;2020-10-15;-183937
2020-10-14;"Nitriansky kraj";80;22;4;26;NA;98786;84;2020-10-14;-184045
2020-10-13;"Nitriansky kraj";101;82;2;84;NA;98786;103;2020-10-13;-184129
2020-10-12;"Nitriansky kraj";36;0;0;0;NA;98786;36;2020-10-12;-184232
2020-10-11;"Nitriansky kraj";8;0;0;0;NA;98786;8;2020-10-11;-184268
2020-10-10;"Nitriansky kraj";107;0;0;0;NA;98786;107;2020-10-10;-184276
2020-10-09;"Nitriansky kraj";120;0;0;0;NA;98786;120;2020-10-09;-184383
2020-10-08;"Nitriansky kraj";132;0;0;0;NA;98786;132;2020-10-08;-184503
2020-10-07;"Nitriansky kraj";81;0;0;0;NA;98786;81;2020-10-07;-184635
2020-10-06;"Nitriansky kraj";48;0;0;0;NA;98786;48;2020-10-06;-184716
2020-10-05;"Nitriansky kraj";20;0;0;0;NA;98786;20;2020-10-05;-184764
2020-10-04;"Nitriansky kraj";17;0;0;0;NA;98786;17;2020-10-04;-184784
2020-10-03;"Nitriansky kraj";96;0;0;0;NA;98786;96;2020-10-03;-184801
2020-10-02;"Nitriansky kraj";108;0;0;0;NA;98786;108;2020-10-02;-184897
2020-10-01;"Nitriansky kraj";95;0;0;0;NA;98786;95;2020-10-01;-185005
2020-09-30;"Nitriansky kraj";100;0;0;0;NA;98786;100;2020-09-30;-185100
2020-09-29;"Nitriansky kraj";50;0;0;0;NA;98786;50;2020-09-29;-185200
2020-09-28;"Nitriansky kraj";22;0;0;0;NA;98786;22;2020-09-28;-185250
2020-09-27;"Nitriansky kraj";16;0;0;0;NA;98786;16;2020-09-27;-185272
2020-09-26;"Nitriansky kraj";64;0;0;0;NA;98786;64;2020-09-26;-185288
2020-09-25;"Nitriansky kraj";90;0;0;0;NA;98786;90;2020-09-25;-185352
2020-09-24;"Nitriansky kraj";51;0;0;0;NA;98786;51;2020-09-24;-185442
2020-09-23;"Nitriansky kraj";70;0;0;0;NA;98786;70;2020-09-23;-185493
2020-09-22;"Nitriansky kraj";18;0;0;0;NA;98786;18;2020-09-22;-185563
2020-09-21;"Nitriansky kraj";10;0;0;0;NA;98786;10;2020-09-21;-185581
2020-09-20;"Nitriansky kraj";4;0;0;0;NA;98786;4;2020-09-20;-185591
2020-09-19;"Nitriansky kraj";14;0;0;0;NA;98786;14;2020-09-19;-185595
2020-09-18;"Nitriansky kraj";19;0;0;0;NA;98786;19;2020-09-18;-185609
2020-09-17;"Nitriansky kraj";30;0;0;0;NA;98786;30;2020-09-17;-185628
2020-09-16;"Nitriansky kraj";6;0;0;0;NA;98786;6;2020-09-16;-185658
2020-09-15;"Nitriansky kraj";19;0;0;0;NA;98786;19;2020-09-15;-185664
2020-09-14;"Nitriansky kraj";28;0;0;0;NA;98786;28;2020-09-14;-185683
2020-09-13;"Nitriansky kraj";3;0;0;0;NA;98786;3;2020-09-13;-185711
2020-09-12;"Nitriansky kraj";12;0;0;0;NA;98786;12;2020-09-12;-185714
2020-09-11;"Nitriansky kraj";23;0;0;0;NA;98786;23;2020-09-11;-185726
2020-09-10;"Nitriansky kraj";29;0;0;0;NA;98786;29;2020-09-10;-185749
2020-09-09;"Nitriansky kraj";19;0;0;0;NA;98786;19;2020-09-09;-185778
2020-09-08;"Nitriansky kraj";17;0;0;0;NA;98786;17;2020-09-08;-185797
2020-09-07;"Nitriansky kraj";17;0;0;0;NA;98786;17;2020-09-07;-185814
2020-09-06;"Nitriansky kraj";0;0;0;0;NA;98786;0;2020-09-06;-185831
2020-09-05;"Nitriansky kraj";22;0;0;0;NA;98786;22;2020-09-05;-185831
2020-09-04;"Nitriansky kraj";34;0;0;0;NA;98786;34;2020-09-04;-185853
2020-09-03;"Nitriansky kraj";15;0;0;0;NA;98786;15;2020-09-03;-185887
2020-09-02;"Nitriansky kraj";15;0;0;0;NA;98786;15;2020-09-02;-185902
2020-09-01;"Nitriansky kraj";2;0;0;0;NA;98786;2;2020-09-01;-185917
2020-08-31;"Nitriansky kraj";12;0;0;0;NA;98786;12;2020-08-31;-185919
2020-08-30;"Nitriansky kraj";1;0;0;0;NA;98786;1;2020-08-30;-185931
2020-08-29;"Nitriansky kraj";7;46;0;46;NA;98786;7;2020-08-29;-185932
2020-08-28;"Nitriansky kraj";12;0;0;0;NA;98786;12;2020-08-28;-185939
2020-08-27;"Nitriansky kraj";12;0;0;0;NA;98786;12;2020-08-27;-185951
2020-08-26;"Nitriansky kraj";4;0;0;0;NA;98786;4;2020-08-26;-185963
2020-08-25;"Nitriansky kraj";8;0;0;0;NA;98786;8;2020-08-25;-185967
2020-08-24;"Nitriansky kraj";1;0;0;0;NA;98786;1;2020-08-24;-185975
2020-08-23;"Nitriansky kraj";1;0;0;0;NA;98786;1;2020-08-23;-185976
2020-08-22;"Nitriansky kraj";2;0;0;0;NA;98786;2;2020-08-22;-185977
2020-08-21;"Nitriansky kraj";0;0;0;0;NA;98786;0;2020-08-21;-185979
2020-08-20;"Nitriansky kraj";7;0;0;0;NA;98786;7;2020-08-20;-185979
2020-08-19;"Nitriansky kraj";1;0;0;0;NA;98786;1;2020-08-19;-185986
2020-08-18;"Nitriansky kraj";2;0;0;0;NA;98786;2;2020-08-18;-185987
2020-08-17;"Nitriansky kraj";1;0;0;0;NA;98786;1;2020-08-17;-185989
2020-08-16;"Nitriansky kraj";0;0;0;0;NA;98786;0;2020-08-16;-185990
2020-08-15;"Nitriansky kraj";2;0;0;0;NA;98786;2;2020-08-15;-185990
2020-08-14;"Nitriansky kraj";1;0;0;0;NA;98786;1;2020-08-14;-185992
2020-08-13;"Nitriansky kraj";4;0;0;0;NA;98786;4;2020-08-13;-185993
2020-08-12;"Nitriansky kraj";0;0;0;0;NA;98786;0;2020-08-12;-185997
2020-08-11;"Nitriansky kraj";1;0;0;0;NA;98786;1;2020-08-11;-185997
2020-08-10;"Nitriansky kraj";0;0;0;0;NA;98786;0;2020-08-10;-185998
2020-08-09;"Nitriansky kraj";0;0;0;0;NA;98786;0;2020-08-09;-185998
2020-08-08;"Nitriansky kraj";0;0;0;0;NA;98786;0;2020-08-08;-185998
2020-08-07;"Nitriansky kraj";4;0;0;0;NA;98786;4;2020-08-07;-185998
2020-08-06;"Nitriansky kraj";4;0;0;0;NA;98786;4;2020-08-06;-186002
2020-08-05;"Nitriansky kraj";0;0;0;0;NA;98786;0;2020-08-05;-186006
2020-08-04;"Nitriansky kraj";7;0;0;0;NA;98786;7;2020-08-04;-186006
2020-08-03;"Nitriansky kraj";0;0;0;0;NA;98786;0;2020-08-03;-186013
2020-08-02;"Nitriansky kraj";0;0;0;0;NA;98786;0;2020-08-02;-186013
2020-08-01;"Nitriansky kraj";0;0;0;0;NA;98786;0;2020-08-01;-186013
2020-07-31;"Nitriansky kraj";0;0;0;0;NA;98786;0;2020-07-31;-186013
2020-07-30;"Nitriansky kraj";0;0;0;0;NA;98786;0;2020-07-30;-186013
2020-07-29;"Nitriansky kraj";0;0;0;0;NA;98786;0;2020-07-29;-186013
2020-07-28;"Nitriansky kraj";0;0;0;0;NA;98786;0;2020-07-28;-186013
2020-07-27;"Nitriansky kraj";0;0;0;0;NA;98786;0;2020-07-27;-186013
2020-07-26;"Nitriansky kraj";0;0;0;0;NA;98786;0;2020-07-26;-186013
2020-07-25;"Nitriansky kraj";0;0;0;0;NA;98786;0;2020-07-25;-186013
2020-07-24;"Nitriansky kraj";1;0;0;0;NA;98786;1;2020-07-24;-186013
2020-07-23;"Nitriansky kraj";3;0;0;0;NA;98786;3;2020-07-23;-186014
2020-07-22;"Nitriansky kraj";2;0;0;0;NA;98786;2;2020-07-22;-186017
2020-07-21;"Nitriansky kraj";14;0;0;0;NA;98786;14;2020-07-21;-186019
2020-07-20;"Nitriansky kraj";11;0;0;0;NA;98786;11;2020-07-20;-186033
2020-07-19;"Nitriansky kraj";0;0;0;0;NA;98786;0;2020-07-19;-186044
2020-07-18;"Nitriansky kraj";0;0;0;0;NA;98786;0;2020-07-18;-186044
2020-07-17;"Nitriansky kraj";0;0;0;0;NA;98786;0;2020-07-17;-186044
2020-07-16;"Nitriansky kraj";4;0;0;0;NA;98786;4;2020-07-16;-186044
2020-07-15;"Nitriansky kraj";5;0;0;0;NA;98786;5;2020-07-15;-186048
2020-07-14;"Nitriansky kraj";0;0;0;0;NA;98786;0;2020-07-14;-186053
2020-07-13;"Nitriansky kraj";0;0;0;0;NA;98786;0;2020-07-13;-186053
2020-07-12;"Nitriansky kraj";0;0;0;0;NA;98786;0;2020-07-12;-186053
2020-07-11;"Nitriansky kraj";0;0;0;0;NA;98786;0;2020-07-11;-186053
2020-07-10;"Nitriansky kraj";0;0;0;0;NA;98786;0;2020-07-10;-186053
2020-07-09;"Nitriansky kraj";1;0;0;0;NA;98786;1;2020-07-09;-186053
2020-07-08;"Nitriansky kraj";2;0;0;0;NA;98786;2;2020-07-08;-186054
2020-07-07;"Nitriansky kraj";0;0;0;0;NA;98786;0;2020-07-07;-186056
2020-07-06;"Nitriansky kraj";0;0;0;0;NA;98786;0;2020-07-06;-186056
2020-07-05;"Nitriansky kraj";0;0;0;0;NA;98786;0;2020-07-05;-186056
2020-07-04;"Nitriansky kraj";0;0;0;0;NA;98786;0;2020-07-04;-186056
2020-07-03;"Nitriansky kraj";0;0;0;0;NA;98786;0;2020-07-03;-186056
2020-07-02;"Nitriansky kraj";0;0;0;0;NA;98786;0;2020-07-02;-186056
2020-07-01;"Nitriansky kraj";3;0;0;0;NA;98786;3;2020-07-01;-186056
2020-06-30;"Nitriansky kraj";0;0;0;0;NA;98786;0;2020-06-30;-186059
2020-06-29;"Nitriansky kraj";0;0;0;0;NA;98786;0;2020-06-29;-186059
2020-06-28;"Nitriansky kraj";0;0;0;0;NA;98786;0;2020-06-28;-186059
2020-06-27;"Nitriansky kraj";0;0;0;0;NA;98786;0;2020-06-27;-186059
2020-06-26;"Nitriansky kraj";0;0;0;0;NA;98786;0;2020-06-26;-186059
2020-06-25;"Nitriansky kraj";0;0;0;0;NA;98786;0;2020-06-25;-186059
2020-06-24;"Nitriansky kraj";1;0;0;0;NA;98786;1;2020-06-24;-186059
2020-06-23;"Nitriansky kraj";0;0;0;0;NA;98786;0;2020-06-23;-186060
2020-06-22;"Nitriansky kraj";0;0;0;0;NA;98786;0;2020-06-22;-186060
2020-06-21;"Nitriansky kraj";0;0;0;0;NA;98786;0;2020-06-21;-186060
2020-06-20;"Nitriansky kraj";0;0;0;0;NA;98786;0;2020-06-20;-186060
2020-06-19;"Nitriansky kraj";0;0;0;0;NA;98786;0;2020-06-19;-186060
2020-06-18;"Nitriansky kraj";0;0;0;0;NA;98786;0;2020-06-18;-186060
2020-06-17;"Nitriansky kraj";0;0;0;0;NA;98786;0;2020-06-17;-186060
2020-06-16;"Nitriansky kraj";0;0;0;0;NA;98786;0;2020-06-16;-186060
2020-06-14;"Nitriansky kraj";0;0;0;0;NA;98786;0;2020-06-14;-186060
2020-06-13;"Nitriansky kraj";0;0;0;0;NA;98786;0;2020-06-13;-186060
2020-06-12;"Nitriansky kraj";0;0;0;0;NA;98786;0;2020-06-12;-186060
2020-06-11;"Nitriansky kraj";0;0;0;0;NA;98786;0;2020-06-11;-186060
2020-06-10;"Nitriansky kraj";1;0;0;0;NA;98786;1;2020-06-10;-186060
2020-06-09;"Nitriansky kraj";1;0;0;0;NA;98786;1;2020-06-09;-186061
2020-06-08;"Nitriansky kraj";0;0;0;0;NA;98786;0;2020-06-08;-186062
2020-06-07;"Nitriansky kraj";0;0;0;0;NA;98786;0;2020-06-07;-186062
2020-06-05;"Nitriansky kraj";0;0;0;0;NA;98786;0;2020-06-05;-186062
2020-06-03;"Nitriansky kraj";0;0;0;0;NA;98786;0;2020-06-03;-186062
2020-06-02;"Nitriansky kraj";1;0;0;0;NA;98786;1;2020-06-02;-186062
2020-05-31;"Nitriansky kraj";0;0;0;0;NA;98786;0;2020-05-31;-186063
2020-05-29;"Nitriansky kraj";0;0;0;0;NA;98786;0;2020-05-29;-186063
2020-05-27;"Nitriansky kraj";0;0;0;0;NA;98786;0;2020-05-27;-186063
2020-05-26;"Nitriansky kraj";0;0;0;0;NA;98786;0;2020-05-26;-186063
2020-05-25;"Nitriansky kraj";0;0;0;0;NA;98786;0;2020-05-25;-186063
2020-05-24;"Nitriansky kraj";2;0;0;0;NA;98786;2;2020-05-24;-186063
2020-05-23;"Nitriansky kraj";0;0;0;0;NA;98786;0;2020-05-23;-186065
2020-05-22;"Nitriansky kraj";1;0;0;0;NA;98786;1;2020-05-22;-186065
2020-05-21;"Nitriansky kraj";0;0;0;0;NA;98786;0;2020-05-21;-186066
2020-05-20;"Nitriansky kraj";0;0;0;0;NA;98786;0;2020-05-20;-186066
2020-05-19;"Nitriansky kraj";0;0;0;0;NA;98786;0;2020-05-19;-186066
2020-05-17;"Nitriansky kraj";0;0;0;0;NA;98786;0;2020-05-17;-186066
2020-05-16;"Nitriansky kraj";0;0;0;0;NA;98786;0;2020-05-16;-186066
2020-05-15;"Nitriansky kraj";1;0;0;0;NA;98786;1;2020-05-15;-186066
2020-05-14;"Nitriansky kraj";0;0;0;0;NA;98786;0;2020-05-14;-186067
2020-05-13;"Nitriansky kraj";0;0;0;0;NA;98786;0;2020-05-13;-186067
2020-05-12;"Nitriansky kraj";0;0;0;0;NA;98786;0;2020-05-12;-186067
2020-05-11;"Nitriansky kraj";2;0;0;0;NA;98786;2;2020-05-11;-186067
2020-05-09;"Nitriansky kraj";0;0;0;0;NA;98786;0;2020-05-09;-186069
2020-05-07;"Nitriansky kraj";1;0;0;0;NA;98786;1;2020-05-07;-186069
2020-05-06;"Nitriansky kraj";9;0;0;0;NA;98786;9;2020-05-06;-186070
2020-05-05;"Nitriansky kraj";0;0;0;0;NA;98786;0;2020-05-05;-186079
2020-05-04;"Nitriansky kraj";5;0;0;0;NA;98786;5;2020-05-04;-186079
2020-05-03;"Nitriansky kraj";2;0;0;0;NA;98786;2;2020-05-03;-186084
2020-05-02;"Nitriansky kraj";0;0;0;0;NA;98786;0;2020-05-02;-186086
2020-05-01;"Nitriansky kraj";1;0;0;0;NA;98786;1;2020-05-01;-186086
2020-04-30;"Nitriansky kraj";0;0;0;0;NA;98786;0;2020-04-30;-186087
2020-04-29;"Nitriansky kraj";0;0;0;0;NA;98786;0;2020-04-29;-186087
2020-04-28;"Nitriansky kraj";1;0;0;0;NA;98786;1;2020-04-28;-186087
2020-04-27;"Nitriansky kraj";0;0;0;0;NA;98786;0;2020-04-27;-186088
2020-04-26;"Nitriansky kraj";0;0;0;0;NA;98786;0;2020-04-26;-186088
2020-04-25;"Nitriansky kraj";0;0;0;0;NA;98786;0;2020-04-25;-186088
2020-04-24;"Nitriansky kraj";0;0;0;0;NA;98786;0;2020-04-24;-186088
2020-04-23;"Nitriansky kraj";3;0;0;0;NA;98786;3;2020-04-23;-186088
2020-04-22;"Nitriansky kraj";16;0;0;0;NA;98786;16;2020-04-22;-186091
2020-04-21;"Nitriansky kraj";6;0;0;0;NA;98786;6;2020-04-21;-186107
2020-04-20;"Nitriansky kraj";5;0;0;0;NA;98786;5;2020-04-20;-186113
2020-04-19;"Nitriansky kraj";0;0;0;0;NA;98786;0;2020-04-19;-186118
2020-04-18;"Nitriansky kraj";0;0;0;0;NA;98786;0;2020-04-18;-186118
2020-04-17;"Nitriansky kraj";7;0;0;0;NA;98786;7;2020-04-17;-186118
2020-04-16;"Nitriansky kraj";0;0;0;0;NA;98786;0;2020-04-16;-186125
2020-04-15;"Nitriansky kraj";6;0;0;0;NA;98786;6;2020-04-15;-186125
2020-04-14;"Nitriansky kraj";2;0;0;0;NA;98786;2;2020-04-14;-186131
2020-04-13;"Nitriansky kraj";1;0;0;0;NA;98786;1;2020-04-13;-186133
2020-04-12;"Nitriansky kraj";3;0;0;0;NA;98786;3;2020-04-12;-186134
2020-04-11;"Nitriansky kraj";1;0;0;0;NA;98786;1;2020-04-11;-186137
2020-04-10;"Nitriansky kraj";1;0;0;0;NA;98786;1;2020-04-10;-186138
2020-04-09;"Nitriansky kraj";0;0;0;0;NA;98786;0;2020-04-09;-186139
2020-04-08;"Nitriansky kraj";2;0;0;0;NA;98786;2;2020-04-08;-186139
2020-04-07;"Nitriansky kraj";3;0;0;0;NA;98786;3;2020-04-07;-186141
2020-04-06;"Nitriansky kraj";4;0;0;0;NA;98786;4;2020-04-06;-186144
2020-04-05;"Nitriansky kraj";5;0;0;0;NA;98786;5;2020-04-05;-186148
2020-04-04;"Nitriansky kraj";0;0;0;0;NA;98786;0;2020-04-04;-186153
2020-04-03;"Nitriansky kraj";0;0;0;0;NA;98786;0;2020-04-03;-186153
2020-04-02;"Nitriansky kraj";1;0;0;0;NA;98786;1;2020-04-02;-186153
2020-04-01;"Nitriansky kraj";0;0;0;0;NA;98786;0;2020-04-01;-186154
2020-03-31;"Nitriansky kraj";3;0;0;0;NA;98786;3;2020-03-31;-186154
2020-03-30;"Nitriansky kraj";3;0;0;0;NA;98786;3;2020-03-30;-186157
2020-03-29;"Nitriansky kraj";3;0;0;0;NA;98786;3;2020-03-29;-186160
2020-03-28;"Nitriansky kraj";1;0;0;0;NA;98786;1;2020-03-28;-186163
2020-03-27;"Nitriansky kraj";1;0;0;0;NA;98786;1;2020-03-27;-186164
2020-03-26;"Nitriansky kraj";1;0;0;0;NA;98786;1;2020-03-26;-186165
2020-03-25;"Nitriansky kraj";1;0;0;0;NA;98786;1;2020-03-25;-186166
2020-03-24;"Nitriansky kraj";0;0;0;0;NA;98786;0;2020-03-24;-186167
2020-03-23;"Nitriansky kraj";2;0;0;0;NA;98786;2;2020-03-23;-186167
2020-03-22;"Nitriansky kraj";2;0;0;0;NA;98786;2;2020-03-22;-186169
2020-03-21;"Nitriansky kraj";2;0;0;0;NA;98786;2;2020-03-21;-186171
2020-03-20;"Nitriansky kraj";1;0;0;0;NA;98786;1;2020-03-20;-186173
2020-03-19;"Nitriansky kraj";1;0;0;0;NA;98786;1;2020-03-19;-186174
2020-03-18;"Nitriansky kraj";2;0;0;0;NA;98786;2;2020-03-18;-186175
2020-03-17;"Nitriansky kraj";1;0;0;0;NA;98786;1;2020-03-17;-186177
2020-03-16;"Nitriansky kraj";0;0;0;0;NA;98786;0;2020-03-16;-186178
2020-03-15;"Nitriansky kraj";4;0;0;0;NA;98786;4;2020-03-15;-186178
2020-03-14;"Nitriansky kraj";1;0;0;0;NA;98786;1;2020-03-14;-186182
2020-03-13;"Nitriansky kraj";0;0;0;0;NA;98786;0;2020-03-13;-186183
2020-03-12;"Nitriansky kraj";0;0;0;0;NA;98786;0;2020-03-12;-186183
2020-03-11;"Nitriansky kraj";0;0;0;0;NA;98786;0;2020-03-11;-186183
2020-03-09;"Nitriansky kraj";0;0;0;0;NA;98786;0;2020-03-09;-186183
2020-03-08;"Nitriansky kraj";0;0;0;0;NA;98786;0;2020-03-08;-186183
2020-03-07;"Nitriansky kraj";0;0;0;0;NA;98786;0;2020-03-07;-186183
2020-03-06;"Nitriansky kraj";0;0;0;0;NA;98786;0;2020-03-06;-186183
2022-06-26;"Prešovský kraj";3;7;0;7;NA;103158;3;2022-06-26;103158
2022-06-25;"Prešovský kraj";14;21;2;23;NA;103158;16;2022-06-25;103155
2022-06-24;"Prešovský kraj";43;111;11;122;NA;103158;54;2022-06-24;103139
2022-06-23;"Prešovský kraj";24;147;16;163;NA;103158;40;2022-06-23;103085
2022-06-22;"Prešovský kraj";22;140;11;151;NA;103158;33;2022-06-22;103045
2022-06-21;"Prešovský kraj";37;171;21;192;NA;103158;58;2022-06-21;103012
2022-06-20;"Prešovský kraj";33;268;32;300;NA;103158;65;2022-06-20;102954
2022-06-19;"Prešovský kraj";4;51;0;51;NA;103158;4;2022-06-19;102889
2022-06-18;"Prešovský kraj";8;20;1;21;NA;103158;9;2022-06-18;102885
2022-06-17;"Prešovský kraj";28;98;4;102;NA;103158;32;2022-06-17;102876
2022-06-16;"Prešovský kraj";15;225;6;231;NA;103158;21;2022-06-16;102844
2022-06-15;"Prešovský kraj";36;204;12;216;NA;103158;48;2022-06-15;102823
2022-06-14;"Prešovský kraj";28;204;11;215;NA;103158;39;2022-06-14;102775
2022-06-13;"Prešovský kraj";20;373;38;411;NA;103158;58;2022-06-13;102736
2022-06-12;"Prešovský kraj";1;97;2;99;NA;103158;3;2022-06-12;102678
2022-06-11;"Prešovský kraj";8;33;0;33;NA;103158;8;2022-06-11;102675
2022-06-10;"Prešovský kraj";36;174;6;180;NA;103158;42;2022-06-10;102667
2022-06-09;"Prešovský kraj";26;223;4;227;NA;103158;30;2022-06-09;102625
2022-06-08;"Prešovský kraj";28;218;4;222;NA;103158;32;2022-06-08;102595
2022-06-07;"Prešovský kraj";29;226;10;236;NA;103158;39;2022-06-07;102563
2022-06-06;"Prešovský kraj";28;436;26;462;NA;103158;54;2022-06-06;102524
2022-06-05;"Prešovský kraj";0;35;2;37;NA;103158;2;2022-06-05;102470
2022-06-04;"Prešovský kraj";13;39;3;42;NA;103158;16;2022-06-04;102468
2022-06-03;"Prešovský kraj";26;133;13;146;NA;103158;39;2022-06-03;102452
2022-06-02;"Prešovský kraj";22;223;11;234;NA;103158;33;2022-06-02;102413
2022-06-01;"Prešovský kraj";28;274;7;281;NA;103158;35;2022-06-01;102380
2022-05-31;"Prešovský kraj";15;241;3;244;NA;103158;18;2022-05-31;102345
2022-05-30;"Prešovský kraj";12;493;31;524;NA;103158;43;2022-05-30;102327
2022-05-29;"Prešovský kraj";1;48;3;51;NA;103158;4;2022-05-29;102284
2022-05-28;"Prešovský kraj";18;44;1;45;NA;103158;19;2022-05-28;102280
2022-05-27;"Prešovský kraj";25;131;12;143;NA;103158;37;2022-05-27;102261
2022-05-26;"Prešovský kraj";26;314;19;333;NA;103158;45;2022-05-26;102224
2022-05-25;"Prešovský kraj";22;236;11;247;NA;103158;33;2022-05-25;102179
2022-05-24;"Prešovský kraj";31;273;18;291;NA;103158;49;2022-05-24;102146
2022-05-23;"Prešovský kraj";27;623;38;661;NA;103158;65;2022-05-23;102097
2022-05-22;"Prešovský kraj";4;44;2;46;NA;103158;6;2022-05-22;102032
2022-05-21;"Prešovský kraj";19;92;0;92;NA;103158;19;2022-05-21;102026
2022-05-20;"Prešovský kraj";31;343;22;365;NA;103158;53;2022-05-20;102007
2022-05-19;"Prešovský kraj";21;272;7;279;NA;103158;28;2022-05-19;101954
2022-05-18;"Prešovský kraj";42;285;8;293;NA;103158;50;2022-05-18;101926
2022-05-17;"Prešovský kraj";31;288;13;301;NA;103158;44;2022-05-17;101876
2022-05-16;"Prešovský kraj";28;549;57;606;NA;103158;85;2022-05-16;101832
2022-05-15;"Prešovský kraj";4;95;8;103;NA;103158;12;2022-05-15;101747
2022-05-14;"Prešovský kraj";30;134;5;139;NA;103158;35;2022-05-14;101735
2022-05-13;"Prešovský kraj";33;314;13;327;NA;103158;46;2022-05-13;101700
2022-05-12;"Prešovský kraj";38;352;19;371;NA;103158;57;2022-05-12;101654
2022-05-11;"Prešovský kraj";51;348;16;364;NA;103158;67;2022-05-11;101597
2022-05-10;"Prešovský kraj";80;630;43;673;NA;103158;123;2022-05-10;101530
2022-05-09;"Prešovský kraj";28;566;45;611;NA;103158;73;2022-05-09;101407
2022-05-08;"Prešovský kraj";3;105;5;110;NA;103158;8;2022-05-08;101334
2022-05-07;"Prešovský kraj";27;122;8;130;NA;103158;35;2022-05-07;101326
2022-05-06;"Prešovský kraj";52;476;32;508;NA;103158;84;2022-05-06;101291
2022-05-05;"Prešovský kraj";58;409;17;426;NA;103158;75;2022-05-05;101207
2022-05-04;"Prešovský kraj";61;588;48;636;NA;103158;109;2022-05-04;101132
2022-05-03;"Prešovský kraj";96;846;28;874;NA;103158;124;2022-05-03;101023
2022-05-02;"Prešovský kraj";112;839;42;881;NA;103158;154;2022-05-02;100899
2022-05-01;"Prešovský kraj";13;164;12;176;NA;103158;25;2022-05-01;100745
2022-04-30;"Prešovský kraj";117;287;13;300;NA;103158;130;2022-04-30;100720
2022-04-29;"Prešovský kraj";150;841;31;872;NA;103158;181;2022-04-29;100590
2022-04-28;"Prešovský kraj";96;856;34;890;NA;103158;130;2022-04-28;100409
2022-04-27;"Prešovský kraj";177;1061;32;1093;NA;103158;209;2022-04-27;100279
2022-04-26;"Prešovský kraj";197;1106;38;1144;NA;103158;235;2022-04-26;100070
2022-04-25;"Prešovský kraj";229;1343;54;1397;NA;103158;283;2022-04-25;99835
2022-04-24;"Prešovský kraj";56;279;8;287;NA;103158;64;2022-04-24;99552
2022-04-23;"Prešovský kraj";121;277;11;288;NA;103158;132;2022-04-23;99488
2022-04-22;"Prešovský kraj";226;908;41;949;NA;103158;267;2022-04-22;99356
2022-04-21;"Prešovský kraj";193;1340;38;1378;NA;103158;231;2022-04-21;99089
2022-04-20;"Prešovský kraj";305;1236;40;1276;NA;103158;345;2022-04-20;98858
2022-04-19;"Prešovský kraj";332;1489;68;1557;NA;103158;400;2022-04-19;98513
2022-04-18;"Prešovský kraj";74;299;43;342;NA;103158;117;2022-04-18;98113
2022-04-17;"Prešovský kraj";117;172;10;182;NA;103158;127;2022-04-17;97996
2022-04-16;"Prešovský kraj";93;285;30;315;NA;103158;123;2022-04-16;97869
2022-04-15;"Prešovský kraj";125;207;1;208;NA;103158;126;2022-04-15;97746
2022-04-14;"Prešovský kraj";303;934;47;981;NA;103158;350;2022-04-14;97620
2022-04-13;"Prešovský kraj";352;1093;54;1147;NA;103158;406;2022-04-13;97270
2022-04-12;"Prešovský kraj";208;1222;58;1280;NA;103158;266;2022-04-12;96864
2022-04-11;"Prešovský kraj";437;1983;104;2087;NA;103158;541;2022-04-11;96598
2022-04-10;"Prešovský kraj";97;421;40;461;NA;103158;137;2022-04-10;96057
2022-04-09;"Prešovský kraj";234;346;42;388;NA;103158;276;2022-04-09;95920
2022-04-08;"Prešovský kraj";368;1290;86;1376;NA;103158;454;2022-04-08;95644
2022-04-07;"Prešovský kraj";442;1324;82;1406;NA;103158;524;2022-04-07;95190
2022-04-06;"Prešovský kraj";582;1297;96;1393;NA;103158;678;2022-04-06;94666
2022-04-05;"Prešovský kraj";596;1734;99;1833;NA;103158;695;2022-04-05;93988
2022-04-04;"Prešovský kraj";804;2064;169;2233;NA;103158;973;2022-04-04;93293
2022-04-03;"Prešovský kraj";159;579;76;655;NA;103158;235;2022-04-03;92320
2022-04-02;"Prešovský kraj";359;408;41;449;NA;103158;400;2022-04-02;92085
2022-04-01;"Prešovský kraj";621;1407;120;1527;NA;103158;741;2022-04-01;91685
2022-03-31;"Prešovský kraj";717;2187;132;2319;NA;103158;849;2022-03-31;90944
2022-03-30;"Prešovský kraj";973;2061;154;2215;NA;103158;1127;2022-03-30;90095
2022-03-29;"Prešovský kraj";645;2078;164;2242;NA;103158;809;2022-03-29;88968
2022-03-28;"Prešovský kraj";946;3199;256;3455;NA;103158;1202;2022-03-28;88159
2022-03-27;"Prešovský kraj";256;793;101;894;NA;103158;357;2022-03-27;86957
2022-03-26;"Prešovský kraj";719;663;80;743;NA;103158;799;2022-03-26;86600
2022-03-25;"Prešovský kraj";895;1956;227;2183;NA;103158;1122;2022-03-25;85801
2022-03-24;"Prešovský kraj";909;2153;200;2353;NA;103158;1109;2022-03-24;84679
2022-03-23;"Prešovský kraj";1291;2147;209;2356;NA;103158;1500;2022-03-23;83570
2022-03-22;"Prešovský kraj";1398;2251;192;2443;NA;103158;1590;2022-03-22;82070
2022-03-21;"Prešovský kraj";1234;3002;290;3292;NA;103158;1524;2022-03-21;80480
2022-03-20;"Prešovský kraj";262;813;130;943;NA;103158;392;2022-03-20;78956
2022-03-19;"Prešovský kraj";802;902;115;1017;NA;103158;917;2022-03-19;78564
2022-03-18;"Prešovský kraj";1217;2105;225;2330;NA;103158;1442;2022-03-18;77647
2022-03-17;"Prešovský kraj";1118;2446;182;2628;NA;103158;1300;2022-03-17;76205
2022-03-16;"Prešovský kraj";1585;2084;222;2306;NA;103158;1807;2022-03-16;74905
2022-03-15;"Prešovský kraj";1460;2329;217;2546;NA;103158;1677;2022-03-15;73098
2022-03-14;"Prešovský kraj";1438;3310;380;3690;NA;103158;1818;2022-03-14;71421
2022-03-13;"Prešovský kraj";432;1045;190;1235;NA;103158;622;2022-03-13;69603
2022-03-12;"Prešovský kraj";1150;857;117;974;NA;103158;1267;2022-03-12;68981
2022-03-11;"Prešovský kraj";1271;2553;287;2840;NA;103158;1558;2022-03-11;67714
2022-03-10;"Prešovský kraj";1114;2577;278;2855;NA;103158;1392;2022-03-10;66156
2022-03-09;"Prešovský kraj";1477;2815;345;3160;NA;103158;1822;2022-03-09;64764
2022-03-08;"Prešovský kraj";1716;2999;308;3307;NA;103158;2024;2022-03-08;62942
2022-03-07;"Prešovský kraj";1326;4197;509;4706;NA;103158;1835;2022-03-07;60918
2022-03-06;"Prešovský kraj";278;1650;232;1882;NA;103158;510;2022-03-06;59083
2022-03-05;"Prešovský kraj";785;1194;136;1330;NA;103158;921;2022-03-05;58573
2022-03-04;"Prešovský kraj";1263;2812;303;3115;NA;103158;1566;2022-03-04;57652
2022-03-03;"Prešovský kraj";1049;3016;373;3389;NA;103158;1422;2022-03-03;56086
2022-03-02;"Prešovský kraj";1526;2955;335;3290;NA;103158;1861;2022-03-02;54664
2022-03-01;"Prešovský kraj";1612;3302;338;3640;NA;103158;1950;2022-03-01;52803
2022-02-28;"Prešovský kraj";1234;4963;538;5501;NA;103158;1772;2022-02-28;50853
2022-02-27;"Prešovský kraj";523;1467;278;1745;NA;103158;801;2022-02-27;49081
2022-02-26;"Prešovský kraj";867;1317;167;1484;NA;103158;1034;2022-02-26;48280
2022-02-25;"Prešovský kraj";1740;2768;346;3114;NA;103158;2086;2022-02-25;47246
2022-02-24;"Prešovský kraj";1435;3301;399;3700;NA;103158;1834;2022-02-24;45160
2022-02-23;"Prešovský kraj";1837;3516;404;3920;NA;103158;2241;2022-02-23;43326
2022-02-22;"Prešovský kraj";2294;3893;407;4300;NA;103158;2701;2022-02-22;41085
2022-02-21;"Prešovský kraj";1609;5165;618;5783;NA;103158;2227;2022-02-21;38384
2022-02-20;"Prešovský kraj";759;1877;319;2196;NA;103158;1078;2022-02-20;36157
2022-02-19;"Prešovský kraj";1535;1556;247;1803;NA;103158;1782;2022-02-19;35079
2022-02-18;"Prešovský kraj";2332;3580;393;3973;NA;103158;2725;2022-02-18;33297
2022-02-17;"Prešovský kraj";2293;3740;457;4197;NA;103158;2750;2022-02-17;30572
2022-02-16;"Prešovský kraj";2494;4049;484;4533;NA;103158;2978;2022-02-16;27822
2022-02-15;"Prešovský kraj";2992;4583;551;5134;NA;103158;3543;2022-02-15;24844
2022-02-14;"Prešovský kraj";2122;6203;845;7048;NA;103158;2967;2022-02-14;21301
2022-02-13;"Prešovský kraj";1338;2452;434;2886;NA;103158;1772;2022-02-13;18334
2022-02-12;"Prešovský kraj";2333;1867;352;2219;NA;103158;2685;2022-02-12;16562
2022-02-11;"Prešovský kraj";2666;3931;520;4451;NA;103158;3186;2022-02-11;13877
2022-02-10;"Prešovský kraj";2977;4518;599;5117;NA;103158;3576;2022-02-10;10691
2022-02-09;"Prešovský kraj";2644;4502;634;5136;NA;103158;3278;2022-02-09;7115
2022-02-08;"Prešovský kraj";3387;4890;651;5541;NA;103158;4038;2022-02-08;3837
2022-02-07;"Prešovský kraj";2132;6920;941;7861;NA;103158;3073;2022-02-07;-201
2022-02-06;"Prešovský kraj";1360;2884;490;3374;NA;103158;1850;2022-02-06;-3274
2022-02-05;"Prešovský kraj";2813;1993;334;2327;NA;103158;3147;2022-02-05;-5124
2022-02-04;"Prešovský kraj";2944;4556;573;5129;NA;103158;3517;2022-02-04;-8271
2022-02-03;"Prešovský kraj";3375;5205;487;5692;NA;103158;3862;2022-02-03;-11788
2022-02-02;"Prešovský kraj";3150;5686;562;6248;NA;103158;3712;2022-02-02;-15650
2022-02-01;"Prešovský kraj";2791;5694;631;6325;NA;103158;3422;2022-02-01;-19362
2022-01-31;"Prešovský kraj";2444;9142;929;10071;NA;103158;3373;2022-01-31;-22784
2022-01-30;"Prešovský kraj";1311;3437;495;3932;NA;103158;1806;2022-01-30;-26157
2022-01-29;"Prešovský kraj";2291;1949;282;2231;NA;103158;2573;2022-01-29;-27963
2022-01-28;"Prešovský kraj";2473;4784;486;5270;NA;103158;2959;2022-01-28;-30536
2022-01-27;"Prešovský kraj";2353;4558;412;4970;NA;103158;2765;2022-01-27;-33495
2022-01-26;"Prešovský kraj";2311;5628;405;6033;NA;103158;2716;2022-01-26;-36260
2022-01-25;"Prešovský kraj";2127;5284;346;5630;NA;103158;2473;2022-01-25;-38976
2022-01-24;"Prešovský kraj";1324;7619;410;8029;NA;103158;1734;2022-01-24;-41449
2022-01-23;"Prešovský kraj";262;3584;218;3802;NA;103158;480;2022-01-23;-43183
2022-01-22;"Prešovský kraj";1448;1764;157;1921;NA;103158;1605;2022-01-22;-43663
2022-01-21;"Prešovský kraj";1128;4312;196;4508;NA;103158;1324;2022-01-21;-45268
2022-01-20;"Prešovský kraj";1184;4012;156;4168;NA;103158;1340;2022-01-20;-46592
2022-01-19;"Prešovský kraj";822;4781;173;4954;NA;103158;995;2022-01-19;-47932
2022-01-18;"Prešovský kraj";1032;4918;163;5081;NA;103158;1195;2022-01-18;-48927
2022-01-17;"Prešovský kraj";784;7143;150;7293;NA;103158;934;2022-01-17;-50122
2022-01-16;"Prešovský kraj";113;3113;98;3211;NA;103158;211;2022-01-16;-51056
2022-01-15;"Prešovský kraj";675;1546;64;1610;NA;103158;739;2022-01-15;-51267
2022-01-14;"Prešovský kraj";202;3792;78;3870;NA;103158;280;2022-01-14;-52006
2022-01-13;"Prešovský kraj";252;3550;89;3639;NA;103158;341;2022-01-13;-52286
2022-01-12;"Prešovský kraj";431;4183;77;4260;NA;103158;508;2022-01-12;-52627
2022-01-11;"Prešovský kraj";438;4812;80;4892;NA;103158;518;2022-01-11;-53135
2022-01-10;"Prešovský kraj";469;7561;135;7696;NA;103158;604;2022-01-10;-53653
2022-01-09;"Prešovský kraj";114;4129;78;4207;NA;103158;192;2022-01-09;-54257
2022-01-08;"Prešovský kraj";291;2097;39;2136;NA;103158;330;2022-01-08;-54449
2022-01-07;"Prešovský kraj";370;3882;106;3988;NA;103158;476;2022-01-07;-54779
2022-01-06;"Prešovský kraj";104;1000;43;1043;NA;103158;147;2022-01-06;-55255
2022-01-05;"Prešovský kraj";373;4752;100;4852;NA;103158;473;2022-01-05;-55402
2022-01-04;"Prešovský kraj";428;4558;77;4635;NA;103158;505;2022-01-04;-55875
2022-01-03;"Prešovský kraj";390;6868;105;6973;NA;103158;495;2022-01-03;-56380
2022-01-02;"Prešovský kraj";158;3180;75;3255;NA;103158;233;2022-01-02;-56875
2022-01-01;"Prešovský kraj";55;379;8;387;NA;103158;63;2022-01-01;-57108
2021-12-31;"Prešovský kraj";220;2217;77;2294;NA;103158;297;2021-12-31;-57171
2021-12-30;"Prešovský kraj";230;2985;81;3066;NA;103158;311;2021-12-30;-57468
2021-12-29;"Prešovský kraj";298;3924;73;3997;NA;103158;371;2021-12-29;-57779
2021-12-28;"Prešovský kraj";365;3625;60;3685;NA;103158;425;2021-12-28;-58150
2021-12-27;"Prešovský kraj";593;5336;93;5429;NA;103158;686;2021-12-27;-58575
2021-12-26;"Prešovský kraj";112;1584;62;1646;NA;103158;174;2021-12-26;-59261
2021-12-25;"Prešovský kraj";12;600;29;629;NA;103158;41;2021-12-25;-59435
2021-12-24;"Prešovský kraj";27;463;26;489;NA;103158;53;2021-12-24;-59476
2021-12-23;"Prešovský kraj";623;3125;76;3201;NA;103158;699;2021-12-23;-59529
2021-12-22;"Prešovský kraj";234;3600;86;3686;NA;103158;320;2021-12-22;-60228
2021-12-21;"Prešovský kraj";520;4571;78;4649;NA;103158;598;2021-12-21;-60548
2021-12-20;"Prešovský kraj";371;7190;107;7297;NA;103158;478;2021-12-20;-61146
2021-12-19;"Prešovský kraj";110;3166;74;3240;NA;103158;184;2021-12-19;-61624
2021-12-18;"Prešovský kraj";313;1562;61;1623;NA;103158;374;2021-12-18;-61808
2021-12-17;"Prešovský kraj";429;4482;96;4578;NA;103158;525;2021-12-17;-62182
2021-12-16;"Prešovský kraj";401;4557;95;4652;NA;103158;496;2021-12-16;-62707
2021-12-15;"Prešovský kraj";473;4499;79;4578;NA;103158;552;2021-12-15;-63203
2021-12-14;"Prešovský kraj";662;5468;125;5593;NA;103158;787;2021-12-14;-63755
2021-12-13;"Prešovský kraj";588;8085;175;8260;NA;103158;763;2021-12-13;-64542
2021-12-12;"Prešovský kraj";160;3852;106;3958;NA;103158;266;2021-12-12;-65305
2021-12-11;"Prešovský kraj";483;2040;91;2131;NA;103158;574;2021-12-11;-65571
2021-12-10;"Prešovský kraj";649;5018;140;5158;NA;103158;789;2021-12-10;-66145
2021-12-09;"Prešovský kraj";669;4702;135;4837;NA;103158;804;2021-12-09;-66934
2021-12-08;"Prešovský kraj";944;4794;167;4961;NA;103158;1111;2021-12-08;-67738
2021-12-07;"Prešovský kraj";1217;5853;188;6041;NA;103158;1405;2021-12-07;-68849
2021-12-06;"Prešovský kraj";784;8604;247;8851;NA;103158;1031;2021-12-06;-70254
2021-12-05;"Prešovský kraj";145;4439;133;4572;NA;103158;278;2021-12-05;-71285
2021-12-04;"Prešovský kraj";1025;2290;127;2417;NA;103158;1152;2021-12-04;-71563
2021-12-03;"Prešovský kraj";1040;5268;231;5499;NA;103158;1271;2021-12-03;-72715
2021-12-02;"Prešovský kraj";2255;5291;183;5474;NA;103158;2438;2021-12-02;-73986
2021-12-01;"Prešovský kraj";826;5267;239;5506;NA;103158;1065;2021-12-01;-76424
2021-11-30;"Prešovský kraj";1123;6651;265;6916;NA;103158;1388;2021-11-30;-77489
2021-11-29;"Prešovský kraj";583;11478;473;11951;NA;103158;1056;2021-11-29;-78877
2021-11-28;"Prešovský kraj";919;5898;234;6132;NA;103158;1153;2021-11-28;-79933
2021-11-27;"Prešovský kraj";884;2977;219;3196;NA;103158;1103;2021-11-27;-81086
2021-11-26;"Prešovský kraj";1311;5890;328;6218;NA;103158;1639;2021-11-26;-82189
2021-11-25;"Prešovský kraj";1285;5051;307;5358;NA;103158;1592;2021-11-25;-83828
2021-11-24;"Prešovský kraj";1209;6120;357;6477;NA;103158;1566;2021-11-24;-85420
2021-11-23;"Prešovský kraj";1099;6631;314;6945;NA;103158;1413;2021-11-23;-86986
2021-11-22;"Prešovský kraj";905;8209;529;8738;NA;103158;1434;2021-11-22;-88399
2021-11-21;"Prešovský kraj";950;3766;316;4082;NA;103158;1266;2021-11-21;-89833
2021-11-20;"Prešovský kraj";1372;2193;222;2415;NA;103158;1594;2021-11-20;-91099
2021-11-19;"Prešovský kraj";1629;5864;452;6316;NA;103158;2081;2021-11-19;-92693
2021-11-18;"Prešovský kraj";823;6696;518;7214;NA;103158;1341;2021-11-18;-94774
2021-11-17;"Prešovský kraj";1648;1336;148;1484;NA;103158;1796;2021-11-17;-96115
2021-11-16;"Prešovský kraj";1346;5511;398;5909;NA;103158;1744;2021-11-16;-97911
2021-11-15;"Prešovský kraj";897;7804;577;8381;NA;103158;1474;2021-11-15;-99655
2021-11-14;"Prešovský kraj";603;3168;311;3479;NA;103158;914;2021-11-14;-101129
2021-11-13;"Prešovský kraj";1255;2068;262;2330;NA;103158;1517;2021-11-13;-102043
2021-11-12;"Prešovský kraj";1358;5236;371;5607;NA;103158;1729;2021-11-12;-103560
2021-11-11;"Prešovský kraj";1218;5087;438;5525;NA;103158;1656;2021-11-11;-105289
2021-11-10;"Prešovský kraj";1278;4966;380;5346;NA;103158;1658;2021-11-10;-106945
2021-11-09;"Prešovský kraj";1038;5431;407;5838;NA;103158;1445;2021-11-09;-108603
2021-11-08;"Prešovský kraj";1068;6987;574;7561;NA;103158;1642;2021-11-08;-110048
2021-11-07;"Prešovský kraj";421;2500;242;2742;NA;103158;663;2021-11-07;-111690
2021-11-06;"Prešovský kraj";1389;1899;234;2133;NA;103158;1623;2021-11-06;-112353
2021-11-05;"Prešovský kraj";1080;4974;367;5341;NA;103158;1447;2021-11-05;-113976
2021-11-04;"Prešovský kraj";1743;5162;322;5484;NA;103158;2065;2021-11-04;-115423
2021-11-03;"Prešovský kraj";1326;5337;387;5724;NA;103158;1713;2021-11-03;-117488
2021-11-02;"Prešovský kraj";1002;7553;556;8109;NA;103158;1558;2021-11-02;-119201
2021-11-01;"Prešovský kraj";347;1402;131;1533;NA;103158;478;2021-11-01;-120759
2021-10-31;"Prešovský kraj";447;2045;210;2255;NA;103158;657;2021-10-31;-121237
2021-10-30;"Prešovský kraj";1148;1928;183;2111;NA;103158;1331;2021-10-30;-121894
2021-10-29;"Prešovský kraj";1360;4460;253;4713;NA;103158;1613;2021-10-29;-123225
2021-10-28;"Prešovský kraj";960;4500;300;4800;NA;103158;1260;2021-10-28;-124838
2021-10-27;"Prešovský kraj";1444;4325;221;4546;NA;103158;1665;2021-10-27;-126098
2021-10-26;"Prešovský kraj";940;5125;217;5342;NA;103158;1157;2021-10-26;-127763
2021-10-25;"Prešovský kraj";673;6077;348;6425;NA;103158;1021;2021-10-25;-128920
2021-10-24;"Prešovský kraj";110;2180;149;2329;NA;103158;259;2021-10-24;-129941
2021-10-23;"Prešovský kraj";1145;1928;141;2069;NA;103158;1286;2021-10-23;-130200
2021-10-22;"Prešovský kraj";792;4876;177;5053;NA;103158;969;2021-10-22;-131486
2021-10-21;"Prešovský kraj";901;4738;191;4929;NA;103158;1092;2021-10-21;-132455
2021-10-20;"Prešovský kraj";833;4199;195;4394;NA;103158;1028;2021-10-20;-133547
2021-10-19;"Prešovský kraj";830;4728;175;4903;NA;103158;1005;2021-10-19;-134575
2021-10-18;"Prešovský kraj";454;5752;240;5992;NA;103158;694;2021-10-18;-135580
2021-10-17;"Prešovský kraj";181;2430;131;2561;NA;103158;312;2021-10-17;-136274
2021-10-16;"Prešovský kraj";561;1924;94;2018;NA;103158;655;2021-10-16;-136586
2021-10-15;"Prešovský kraj";533;4735;107;4842;NA;103158;640;2021-10-15;-137241
2021-10-14;"Prešovský kraj";506;3948;85;4033;NA;103158;591;2021-10-14;-137881
2021-10-13;"Prešovský kraj";549;3794;98;3892;NA;103158;647;2021-10-13;-138472
2021-10-12;"Prešovský kraj";520;3966;101;4067;NA;103158;621;2021-10-12;-139119
2021-10-11;"Prešovský kraj";433;5421;131;5552;NA;103158;564;2021-10-11;-139740
2021-10-10;"Prešovský kraj";78;2099;64;2163;NA;103158;142;2021-10-10;-140304
2021-10-09;"Prešovský kraj";311;2077;47;2124;NA;103158;358;2021-10-09;-140446
2021-10-08;"Prešovský kraj";636;4934;94;5028;NA;103158;730;2021-10-08;-140804
2021-10-07;"Prešovský kraj";487;3919;101;4020;NA;103158;588;2021-10-07;-141534
2021-10-06;"Prešovský kraj";296;3851;104;3955;NA;103158;400;2021-10-06;-142122
2021-10-05;"Prešovský kraj";430;4151;90;4241;NA;103158;520;2021-10-05;-142522
2021-10-04;"Prešovský kraj";353;5569;125;5694;NA;103158;478;2021-10-04;-143042
2021-10-03;"Prešovský kraj";19;2324;47;2371;NA;103158;66;2021-10-03;-143520
2021-10-02;"Prešovský kraj";269;2238;58;2296;NA;103158;327;2021-10-02;-143586
2021-10-01;"Prešovský kraj";325;4997;63;5060;NA;103158;388;2021-10-01;-143913
2021-09-30;"Prešovský kraj";265;4044;83;4127;NA;103158;348;2021-09-30;-144301
2021-09-29;"Prešovský kraj";381;3825;55;3880;NA;103158;436;2021-09-29;-144649
2021-09-28;"Prešovský kraj";312;4714;69;4783;NA;103158;381;2021-09-28;-145085
2021-09-27;"Prešovský kraj";257;5062;104;5166;NA;103158;361;2021-09-27;-145466
2021-09-26;"Prešovský kraj";8;2422;67;2489;NA;103158;75;2021-09-26;-145827
2021-09-25;"Prešovský kraj";134;2540;46;2586;NA;103158;180;2021-09-25;-145902
2021-09-24;"Prešovský kraj";297;4822;61;4883;NA;103158;358;2021-09-24;-146082
2021-09-23;"Prešovský kraj";109;4105;45;4150;NA;103158;154;2021-09-23;-146440
2021-09-22;"Prešovský kraj";177;3836;41;3877;NA;103158;218;2021-09-22;-146594
2021-09-21;"Prešovský kraj";219;5059;66;5125;NA;103158;285;2021-09-21;-146812
2021-09-20;"Prešovský kraj";180;5183;68;5251;NA;103158;248;2021-09-20;-147097
2021-09-19;"Prešovský kraj";7;2726;30;2756;NA;103158;37;2021-09-19;-147345
2021-09-18;"Prešovský kraj";169;2406;37;2443;NA;103158;206;2021-09-18;-147382
2021-09-17;"Prešovský kraj";157;4402;52;4454;NA;103158;209;2021-09-17;-147588
2021-09-16;"Prešovský kraj";146;4371;71;4442;NA;103158;217;2021-09-16;-147797
2021-09-15;"Prešovský kraj";68;701;19;720;NA;103158;87;2021-09-15;-148014
2021-09-14;"Prešovský kraj";133;3369;38;3407;NA;103158;171;2021-09-14;-148101
2021-09-13;"Prešovský kraj";105;4225;37;4262;NA;103158;142;2021-09-13;-148272
2021-09-12;"Prešovský kraj";4;1776;29;1805;NA;103158;33;2021-09-12;-148414
2021-09-11;"Prešovský kraj";65;2012;24;2036;NA;103158;89;2021-09-11;-148447
2021-09-10;"Prešovský kraj";105;3241;30;3271;NA;103158;135;2021-09-10;-148536
2021-09-09;"Prešovský kraj";29;3090;27;3117;NA;103158;56;2021-09-09;-148671
2021-09-08;"Prešovský kraj";73;2444;20;2464;NA;103158;93;2021-09-08;-148727
2021-09-07;"Prešovský kraj";82;2449;24;2473;NA;103158;106;2021-09-07;-148820
2021-09-06;"Prešovský kraj";61;3282;20;3302;NA;103158;81;2021-09-06;-148926
2021-09-05;"Prešovský kraj";5;1338;11;1349;NA;103158;16;2021-09-05;-149007
2021-09-04;"Prešovský kraj";27;1864;14;1878;NA;103158;41;2021-09-04;-149023
2021-09-03;"Prešovský kraj";39;2976;15;2991;NA;103158;54;2021-09-03;-149064
2021-09-02;"Prešovský kraj";39;2558;20;2578;NA;103158;59;2021-09-02;-149118
2021-09-01;"Prešovský kraj";14;575;6;581;NA;103158;20;2021-09-01;-149177
2021-08-31;"Prešovský kraj";47;2438;13;2451;NA;103158;60;2021-08-31;-149197
2021-08-30;"Prešovský kraj";23;2827;19;2846;NA;103158;42;2021-08-30;-149257
2021-08-29;"Prešovský kraj";3;781;1;782;NA;103158;4;2021-08-29;-149299
2021-08-28;"Prešovský kraj";5;2101;8;2109;NA;103158;13;2021-08-28;-149303
2021-08-27;"Prešovský kraj";32;3084;8;3092;NA;103158;40;2021-08-27;-149316
2021-08-26;"Prešovský kraj";13;2094;8;2102;NA;103158;21;2021-08-26;-149356
2021-08-25;"Prešovský kraj";18;1947;4;1951;NA;103158;22;2021-08-25;-149377
2021-08-24;"Prešovský kraj";10;2138;5;2143;NA;103158;15;2021-08-24;-149399
2021-08-23;"Prešovský kraj";16;2576;6;2582;NA;103158;22;2021-08-23;-149414
2021-08-22;"Prešovský kraj";0;1440;6;1446;NA;103158;6;2021-08-22;-149436
2021-08-21;"Prešovský kraj";28;2018;4;2022;NA;103158;32;2021-08-21;-149442
2021-08-20;"Prešovský kraj";15;2906;7;2913;NA;103158;22;2021-08-20;-149474
2021-08-19;"Prešovský kraj";22;2242;8;2250;NA;103158;30;2021-08-19;-149496
2021-08-18;"Prešovský kraj";6;1752;11;1763;NA;103158;17;2021-08-18;-149526
2021-08-17;"Prešovský kraj";29;1829;6;1835;NA;103158;35;2021-08-17;-149543
2021-08-16;"Prešovský kraj";11;2524;7;2531;NA;103158;18;2021-08-16;-149578
2021-08-15;"Prešovský kraj";0;896;2;898;NA;103158;2;2021-08-15;-149596
2021-08-14;"Prešovský kraj";14;1662;1;1663;NA;103158;15;2021-08-14;-149598
2021-08-13;"Prešovský kraj";24;1646;12;1658;NA;103158;36;2021-08-13;-149613
2021-08-12;"Prešovský kraj";9;1752;3;1755;NA;103158;12;2021-08-12;-149649
2021-08-11;"Prešovský kraj";15;1193;3;1196;NA;103158;18;2021-08-11;-149661
2021-08-10;"Prešovský kraj";10;1102;4;1106;NA;103158;14;2021-08-10;-149679
2021-08-09;"Prešovský kraj";13;2156;4;2160;NA;103158;17;2021-08-09;-149693
2021-08-08;"Prešovský kraj";2;675;2;677;NA;103158;4;2021-08-08;-149710
2021-08-07;"Prešovský kraj";5;1114;3;1117;NA;103158;8;2021-08-07;-149714
2021-08-06;"Prešovský kraj";9;1459;4;1463;NA;103158;13;2021-08-06;-149722
2021-08-05;"Prešovský kraj";9;1370;2;1372;NA;103158;11;2021-08-05;-149735
2021-08-04;"Prešovský kraj";6;1007;1;1008;NA;103158;7;2021-08-04;-149746
2021-08-03;"Prešovský kraj";8;976;1;977;NA;103158;9;2021-08-03;-149753
2021-08-02;"Prešovský kraj";5;1477;6;1483;NA;103158;11;2021-08-02;-149762
2021-08-01;"Prešovský kraj";0;738;2;740;NA;103158;2;2021-08-01;-149773
2021-07-31;"Prešovský kraj";20;1080;0;1080;NA;103158;20;2021-07-31;-149775
2021-07-30;"Prešovský kraj";2;1518;1;1519;NA;103158;3;2021-07-30;-149795
2021-07-29;"Prešovský kraj";6;1302;1;1303;NA;103158;7;2021-07-29;-149798
2021-07-28;"Prešovský kraj";6;1106;1;1107;NA;103158;7;2021-07-28;-149805
2021-07-27;"Prešovský kraj";5;1140;2;1142;NA;103158;7;2021-07-27;-149812
2021-07-26;"Prešovský kraj";12;1583;1;1584;NA;103158;13;2021-07-26;-149819
2021-07-25;"Prešovský kraj";0;687;1;688;NA;103158;1;2021-07-25;-149832
2021-07-24;"Prešovský kraj";8;1040;0;1040;NA;103158;8;2021-07-24;-149833
2021-07-23;"Prešovský kraj";8;1608;1;1609;NA;103158;9;2021-07-23;-149841
2021-07-22;"Prešovský kraj";13;1431;10;1441;NA;103158;23;2021-07-22;-149850
2021-07-21;"Prešovský kraj";5;1076;1;1077;NA;103158;6;2021-07-21;-149873
2021-07-20;"Prešovský kraj";4;1064;0;1064;NA;103158;4;2021-07-20;-149879
2021-07-19;"Prešovský kraj";2;1644;4;1648;NA;103158;6;2021-07-19;-149883
2021-07-18;"Prešovský kraj";1;647;0;647;NA;103158;1;2021-07-18;-149889
2021-07-17;"Prešovský kraj";6;1245;1;1246;NA;103158;7;2021-07-17;-149890
2021-07-16;"Prešovský kraj";4;1558;2;1560;NA;103158;6;2021-07-16;-149897
2021-07-15;"Prešovský kraj";5;1310;4;1314;NA;103158;9;2021-07-15;-149903
2021-07-14;"Prešovský kraj";1;1051;2;1053;NA;103158;3;2021-07-14;-149912
2021-07-13;"Prešovský kraj";1;1071;2;1073;NA;103158;3;2021-07-13;-149915
2021-07-12;"Prešovský kraj";1;1949;2;1951;NA;103158;3;2021-07-12;-149918
2021-07-11;"Prešovský kraj";0;660;1;661;NA;103158;1;2021-07-11;-149921
2021-07-10;"Prešovský kraj";4;1229;2;1231;NA;103158;6;2021-07-10;-149922
2021-07-09;"Prešovský kraj";6;1957;1;1958;NA;103158;7;2021-07-09;-149928
2021-07-08;"Prešovský kraj";5;1192;0;1192;NA;103158;5;2021-07-08;-149935
2021-07-07;"Prešovský kraj";7;1468;3;1471;NA;103158;10;2021-07-07;-149940
2021-07-06;"Prešovský kraj";5;1423;2;1425;NA;103158;7;2021-07-06;-149950
2021-07-05;"Prešovský kraj";2;645;0;645;NA;103158;2;2021-07-05;-149957
2021-07-04;"Prešovský kraj";0;788;0;788;NA;103158;0;2021-07-04;-149959
2021-07-03;"Prešovský kraj";2;1391;0;1391;NA;103158;2;2021-07-03;-149959
2021-07-02;"Prešovský kraj";4;1796;0;1796;NA;103158;4;2021-07-02;-149961
2021-07-01;"Prešovský kraj";2;1590;1;1591;NA;103158;3;2021-07-01;-149965
2021-06-30;"Prešovský kraj";3;8829;4;8833;NA;103158;7;2021-06-30;-149968
2021-06-29;"Prešovský kraj";1;4935;3;4938;NA;103158;4;2021-06-29;-149975
2021-06-28;"Prešovský kraj";5;6109;2;6111;NA;103158;7;2021-06-28;-149979
2021-06-27;"Prešovský kraj";0;3852;1;3853;NA;103158;1;2021-06-27;-149986
2021-06-26;"Prešovský kraj";4;5815;1;5816;NA;103158;5;2021-06-26;-149987
2021-06-25;"Prešovský kraj";7;7321;4;7325;NA;103158;11;2021-06-25;-149992
2021-06-24;"Prešovský kraj";10;5406;5;5411;NA;103158;15;2021-06-24;-150003
2021-06-23;"Prešovský kraj";4;5124;2;5126;NA;103158;6;2021-06-23;-150018
2021-06-22;"Prešovský kraj";5;5143;1;5144;NA;103158;6;2021-06-22;-150024
2021-06-21;"Prešovský kraj";13;7033;6;7039;NA;103158;19;2021-06-21;-150030
2021-06-20;"Prešovský kraj";0;5204;3;5207;NA;103158;3;2021-06-20;-150049
2021-06-19;"Prešovský kraj";1;7349;5;7354;NA;103158;6;2021-06-19;-150052
2021-06-18;"Prešovský kraj";9;8682;10;8692;NA;103158;19;2021-06-18;-150058
2021-06-17;"Prešovský kraj";9;6548;5;6553;NA;103158;14;2021-06-17;-150077
2021-06-16;"Prešovský kraj";6;6422;3;6425;NA;103158;9;2021-06-16;-150091
2021-06-15;"Prešovský kraj";2;5709;4;5713;NA;103158;6;2021-06-15;-150100
2021-06-14;"Prešovský kraj";5;8229;13;8242;NA;103158;18;2021-06-14;-150106
2021-06-13;"Prešovský kraj";1;6455;7;6462;NA;103158;8;2021-06-13;-150124
2021-06-12;"Prešovský kraj";3;8904;9;8913;NA;103158;12;2021-06-12;-150132
2021-06-11;"Prešovský kraj";21;9877;9;9886;NA;103158;30;2021-06-11;-150144
2021-06-10;"Prešovský kraj";11;6512;10;6522;NA;103158;21;2021-06-10;-150174
2021-06-09;"Prešovský kraj";16;6375;3;6378;NA;103158;19;2021-06-09;-150195
2021-06-08;"Prešovský kraj";31;6495;12;6507;NA;103158;43;2021-06-08;-150214
2021-06-07;"Prešovský kraj";11;9111;15;9126;NA;103158;26;2021-06-07;-150257
2021-06-06;"Prešovský kraj";0;8016;5;8021;NA;103158;5;2021-06-06;-150283
2021-06-05;"Prešovský kraj";17;10248;15;10263;NA;103158;32;2021-06-05;-150288
2021-06-04;"Prešovský kraj";26;10375;18;10393;NA;103158;44;2021-06-04;-150320
2021-06-03;"Prešovský kraj";14;6820;16;6836;NA;103158;30;2021-06-03;-150364
2021-06-02;"Prešovský kraj";47;7372;14;7386;NA;103158;61;2021-06-02;-150394
2021-06-01;"Prešovský kraj";15;6926;14;6940;NA;103158;29;2021-06-01;-150455
2021-05-31;"Prešovský kraj";27;9951;22;9973;NA;103158;49;2021-05-31;-150484
2021-05-30;"Prešovský kraj";2;9717;14;9731;NA;103158;16;2021-05-30;-150533
2021-05-29;"Prešovský kraj";23;12733;24;12757;NA;103158;47;2021-05-29;-150549
2021-05-28;"Prešovský kraj";30;12468;19;12487;NA;103158;49;2021-05-28;-150596
2021-05-27;"Prešovský kraj";16;7653;37;7690;NA;103158;53;2021-05-27;-150645
2021-05-26;"Prešovský kraj";32;8140;23;8163;NA;103158;55;2021-05-26;-150698
2021-05-25;"Prešovský kraj";38;8690;20;8710;NA;103158;58;2021-05-25;-150753
2021-05-24;"Prešovský kraj";17;13298;37;13335;NA;103158;54;2021-05-24;-150811
2021-05-23;"Prešovský kraj";3;11947;20;11967;NA;103158;23;2021-05-23;-150865
2021-05-22;"Prešovský kraj";11;14422;44;14466;NA;103158;55;2021-05-22;-150888
2021-05-21;"Prešovský kraj";44;13803;24;13827;NA;103158;68;2021-05-21;-150943
2021-05-20;"Prešovský kraj";13;9437;29;9466;NA;103158;42;2021-05-20;-151011
2021-05-19;"Prešovský kraj";60;10756;36;10792;NA;103158;96;2021-05-19;-151053
2021-05-18;"Prešovský kraj";44;9062;27;9089;NA;103158;71;2021-05-18;-151149
2021-05-17;"Prešovský kraj";60;12856;47;12903;NA;103158;107;2021-05-17;-151220
2021-05-16;"Prešovský kraj";20;16302;66;16368;NA;103158;86;2021-05-16;-151327
2021-05-15;"Prešovský kraj";20;24604;81;24685;NA;103158;101;2021-05-15;-151413
2021-05-14;"Prešovský kraj";49;18671;68;18739;NA;103158;117;2021-05-14;-151514
2021-05-13;"Prešovský kraj";54;11166;71;11237;NA;103158;125;2021-05-13;-151631
2021-05-12;"Prešovský kraj";59;10822;39;10861;NA;103158;98;2021-05-12;-151756
2021-05-11;"Prešovský kraj";61;10728;48;10776;NA;103158;109;2021-05-11;-151854
2021-05-10;"Prešovský kraj";79;15726;67;15793;NA;103158;146;2021-05-10;-151963
2021-05-09;"Prešovský kraj";54;21658;82;21740;NA;103158;136;2021-05-09;-152109
2021-05-08;"Prešovský kraj";39;23050;52;23102;NA;103158;91;2021-05-08;-152245
2021-05-07;"Prešovský kraj";81;23543;66;23609;NA;103158;147;2021-05-07;-152336
2021-05-06;"Prešovský kraj";107;12924;66;12990;NA;103158;173;2021-05-06;-152483
2021-05-05;"Prešovský kraj";60;12808;84;12892;NA;103158;144;2021-05-05;-152656
2021-05-04;"Prešovský kraj";203;13470;67;13537;NA;103158;270;2021-05-04;-152800
2021-05-03;"Prešovský kraj";68;18458;109;18567;NA;103158;177;2021-05-03;-153070
2021-05-02;"Prešovský kraj";29;36676;102;36778;NA;103158;131;2021-05-02;-153247
2021-05-01;"Prešovský kraj";70;57153;183;57336;NA;103158;253;2021-05-01;-153378
2021-04-30;"Prešovský kraj";135;39333;118;39451;NA;103158;253;2021-04-30;-153631
2021-04-29;"Prešovský kraj";110;16635;97;16732;NA;103158;207;2021-04-29;-153884
2021-04-28;"Prešovský kraj";122;18671;89;18760;NA;103158;211;2021-04-28;-154091
2021-04-27;"Prešovský kraj";154;19994;120;20114;NA;103158;274;2021-04-27;-154302
2021-04-26;"Prešovský kraj";99;27241;123;27364;NA;103158;222;2021-04-26;-154576
2021-04-25;"Prešovský kraj";9;52776;156;52932;NA;103158;165;2021-04-25;-154798
2021-04-24;"Prešovský kraj";61;85698;243;85941;NA;103158;304;2021-04-24;-154963
2021-04-23;"Prešovský kraj";171;40365;137;40502;NA;103158;308;2021-04-23;-155267
2021-04-22;"Prešovský kraj";86;18104;125;18229;NA;103158;211;2021-04-22;-155575
2021-04-21;"Prešovský kraj";144;21550;139;21689;NA;103158;283;2021-04-21;-155786
2021-04-20;"Prešovský kraj";115;23346;128;23474;NA;103158;243;2021-04-20;-156069
2021-04-19;"Prešovský kraj";106;29133;145;29278;NA;103158;251;2021-04-19;-156312
2021-04-18;"Prešovský kraj";4;51824;129;51953;NA;103158;133;2021-04-18;-156563
2021-04-17;"Prešovský kraj";119;97970;238;98208;NA;103158;357;2021-04-17;-156696
2021-04-16;"Prešovský kraj";135;40989;146;41135;NA;103158;281;2021-04-16;-157053
2021-04-15;"Prešovský kraj";112;20179;137;20316;NA;103158;249;2021-04-15;-157334
2021-04-14;"Prešovský kraj";199;23332;130;23462;NA;103158;329;2021-04-14;-157583
2021-04-13;"Prešovský kraj";180;23907;116;24023;NA;103158;296;2021-04-13;-157912
2021-04-12;"Prešovský kraj";172;30152;175;30327;NA;103158;347;2021-04-12;-158208
2021-04-11;"Prešovský kraj";11;49955;187;50142;NA;103158;198;2021-04-11;-158555
2021-04-10;"Prešovský kraj";94;90181;297;90478;NA;103158;391;2021-04-10;-158753
2021-04-09;"Prešovský kraj";255;37163;200;37363;NA;103158;455;2021-04-09;-159144
2021-04-08;"Prešovský kraj";192;18893;157;19050;NA;103158;349;2021-04-08;-159599
2021-04-07;"Prešovský kraj";314;27797;154;27951;NA;103158;468;2021-04-07;-159948
2021-04-06;"Prešovský kraj";231;41711;268;41979;NA;103158;499;2021-04-06;-160416
2021-04-05;"Prešovský kraj";54;18454;132;18586;NA;103158;186;2021-04-05;-160915
2021-04-04;"Prešovský kraj";31;18569;91;18660;NA;103158;122;2021-04-04;-161101
2021-04-03;"Prešovský kraj";104;90664;321;90985;NA;103158;425;2021-04-03;-161223
2021-04-02;"Prešovský kraj";194;23381;134;23515;NA;103158;328;2021-04-02;-161648
2021-04-01;"Prešovský kraj";256;42879;195;43074;NA;103158;451;2021-04-01;-161976
2021-03-31;"Prešovský kraj";311;30176;227;30403;NA;103158;538;2021-03-31;-162427
2021-03-30;"Prešovský kraj";374;20751;203;20954;NA;103158;577;2021-03-30;-162965
2021-03-29;"Prešovský kraj";219;28188;229;28417;NA;103158;448;2021-03-29;-163542
2021-03-28;"Prešovský kraj";26;46811;256;47067;NA;103158;282;2021-03-28;-163990
2021-03-27;"Prešovský kraj";181;88673;372;89045;NA;103158;553;2021-03-27;-164272
2021-03-26;"Prešovský kraj";310;47751;299;48050;NA;103158;609;2021-03-26;-164825
2021-03-25;"Prešovský kraj";248;22281;213;22494;NA;103158;461;2021-03-25;-165434
2021-03-24;"Prešovský kraj";381;19590;213;19803;NA;103158;594;2021-03-24;-165895
2021-03-23;"Prešovský kraj";241;20351;255;20606;NA;103158;496;2021-03-23;-166489
2021-03-22;"Prešovský kraj";299;28634;287;28921;NA;103158;586;2021-03-22;-166985
2021-03-21;"Prešovský kraj";32;49439;266;49705;NA;103158;298;2021-03-21;-167571
2021-03-20;"Prešovský kraj";180;92529;426;92955;NA;103158;606;2021-03-20;-167869
2021-03-19;"Prešovský kraj";373;46582;326;46908;NA;103158;699;2021-03-19;-168475
2021-03-18;"Prešovský kraj";251;21721;217;21938;NA;103158;468;2021-03-18;-169174
2021-03-17;"Prešovský kraj";331;20887;231;21118;NA;103158;562;2021-03-17;-169642
2021-03-16;"Prešovský kraj";461;21094;278;21372;NA;103158;739;2021-03-16;-170204
2021-03-15;"Prešovský kraj";370;28813;324;29137;NA;103158;694;2021-03-15;-170943
2021-03-14;"Prešovský kraj";52;50410;356;50766;NA;103158;408;2021-03-14;-171637
2021-03-13;"Prešovský kraj";200;94768;531;95299;NA;103158;731;2021-03-13;-172045
2021-03-12;"Prešovský kraj";425;47691;368;48059;NA;103158;793;2021-03-12;-172776
2021-03-11;"Prešovský kraj";463;22059;253;22312;NA;103158;716;2021-03-11;-173569
2021-03-10;"Prešovský kraj";325;20821;293;21114;NA;103158;618;2021-03-10;-174285
2021-03-09;"Prešovský kraj";505;21496;288;21784;NA;103158;793;2021-03-09;-174903
2021-03-08;"Prešovský kraj";314;28903;333;29236;NA;103158;647;2021-03-08;-175696
2021-03-07;"Prešovský kraj";19;48328;388;48716;NA;103158;407;2021-03-07;-176343
2021-03-06;"Prešovský kraj";193;97527;591;98118;NA;103158;784;2021-03-06;-176750
2021-03-05;"Prešovský kraj";497;46054;397;46451;NA;103158;894;2021-03-05;-177534
2021-03-04;"Prešovský kraj";372;22670;359;23029;NA;103158;731;2021-03-04;-178428
2021-03-03;"Prešovský kraj";397;21623;333;21956;NA;103158;730;2021-03-03;-179159
2021-03-02;"Prešovský kraj";421;22682;357;23039;NA;103158;778;2021-03-02;-179889
2021-03-01;"Prešovský kraj";303;27716;406;28122;NA;103158;709;2021-03-01;-180667
2021-02-28;"Prešovský kraj";75;45000;387;45387;NA;103158;462;2021-02-28;-181376
2021-02-27;"Prešovský kraj";273;90231;734;90965;NA;103158;1007;2021-02-27;-181838
2021-02-26;"Prešovský kraj";455;41340;438;41778;NA;103158;893;2021-02-26;-182845
2021-02-25;"Prešovský kraj";270;19496;337;19833;NA;103158;607;2021-02-25;-183738
2021-02-24;"Prešovský kraj";328;19026;377;19403;NA;103158;705;2021-02-24;-184345
2021-02-23;"Prešovský kraj";430;21277;345;21622;NA;103158;775;2021-02-23;-185050
2021-02-22;"Prešovský kraj";351;27180;356;27536;NA;103158;707;2021-02-22;-185825
2021-02-21;"Prešovský kraj";66;31453;301;31754;NA;103158;367;2021-02-21;-186532
2021-02-20;"Prešovský kraj";129;71413;517;71930;NA;103158;646;2021-02-20;-186899
2021-02-19;"Prešovský kraj";381;38995;430;39425;NA;103158;811;2021-02-19;-187545
2021-02-18;"Prešovský kraj";268;16960;322;17282;NA;103158;590;2021-02-18;-188356
2021-02-17;"Prešovský kraj";293;17392;246;17638;NA;103158;539;2021-02-17;-188946
2021-02-16;"Prešovský kraj";422;18862;265;19127;NA;103158;687;2021-02-16;-189485
2021-02-15;"Prešovský kraj";211;31366;303;31669;NA;103158;514;2021-02-15;-190172
2021-02-14;"Prešovský kraj";27;39387;321;39708;NA;103158;348;2021-02-14;-190686
2021-02-13;"Prešovský kraj";157;74747;402;75149;NA;103158;559;2021-02-13;-191034
2021-02-12;"Prešovský kraj";308;38758;365;39123;NA;103158;673;2021-02-12;-191593
2021-02-11;"Prešovský kraj";218;16218;239;16457;NA;103158;457;2021-02-11;-192266
2021-02-10;"Prešovský kraj";220;18542;282;18824;NA;103158;502;2021-02-10;-192723
2021-02-09;"Prešovský kraj";323;21497;370;21867;NA;103158;693;2021-02-09;-193225
2021-02-08;"Prešovský kraj";161;36924;261;37185;NA;103158;422;2021-02-08;-193918
2021-02-07;"Prešovský kraj";21;34227;209;34436;NA;103158;230;2021-02-07;-194340
2021-02-06;"Prešovský kraj";176;69164;360;69524;NA;103158;536;2021-02-06;-194570
2021-02-05;"Prešovský kraj";177;31271;262;31533;NA;103158;439;2021-02-05;-195106
2021-02-04;"Prešovský kraj";176;13080;237;13317;NA;103158;413;2021-02-04;-195545
2021-02-03;"Prešovský kraj";251;8421;236;8657;NA;103158;487;2021-02-03;-195958
2021-02-02;"Prešovský kraj";249;11769;264;12033;NA;103158;513;2021-02-02;-196445
2021-02-01;"Prešovský kraj";220;16059;316;16375;NA;103158;536;2021-02-01;-196958
2021-01-31;"Prešovský kraj";42;10587;107;10694;NA;103158;149;2021-01-31;-197494
2021-01-30;"Prešovský kraj";142;23939;215;24154;NA;103158;357;2021-01-30;-197643
2021-01-29;"Prešovský kraj";185;17924;326;18250;NA;103158;511;2021-01-29;-198000
2021-01-28;"Prešovský kraj";311;7348;150;7498;NA;103158;461;2021-01-28;-198511
2021-01-27;"Prešovský kraj";153;9730;147;9877;NA;103158;300;2021-01-27;-198972
2021-01-26;"Prešovský kraj";252;16653;151;16804;NA;103158;403;2021-01-26;-199272
2021-01-25;"Prešovský kraj";196;30092;253;30345;NA;103158;449;2021-01-25;-199675
2021-01-24;"Prešovský kraj";12;45706;304;46010;NA;103158;316;2021-01-24;-200124
2021-01-23;"Prešovský kraj";189;96883;487;97370;NA;103158;676;2021-01-23;-200440
2021-01-22;"Prešovský kraj";187;35383;261;35644;NA;103158;448;2021-01-22;-201116
2021-01-21;"Prešovský kraj";187;20434;212;20646;NA;103158;399;2021-01-21;-201564
2021-01-20;"Prešovský kraj";253;14782;195;14977;NA;103158;448;2021-01-20;-201963
2021-01-19;"Prešovský kraj";281;12329;305;12634;NA;103158;586;2021-01-19;-202411
2021-01-18;"Prešovský kraj";203;10422;336;10758;NA;103158;539;2021-01-18;-202997
2021-01-17;"Prešovský kraj";107;14391;1008;15399;NA;103158;1115;2021-01-17;-203536
2021-01-16;"Prešovský kraj";72;1838;81;1919;NA;103158;153;2021-01-16;-204651
2021-01-15;"Prešovský kraj";159;7033;257;7290;NA;103158;416;2021-01-15;-204804
2021-01-14;"Prešovský kraj";268;5534;256;5790;NA;103158;524;2021-01-14;-205220
2021-01-13;"Prešovský kraj";342;5649;226;5875;NA;103158;568;2021-01-13;-205744
2021-01-12;"Prešovský kraj";455;8251;386;8637;NA;103158;841;2021-01-12;-206312
2021-01-11;"Prešovský kraj";343;8149;471;8620;NA;103158;814;2021-01-11;-207153
2021-01-10;"Prešovský kraj";63;476;23;499;NA;103158;86;2021-01-10;-207967
2021-01-09;"Prešovský kraj";439;2248;125;2373;NA;103158;564;2021-01-09;-208053
2021-01-08;"Prešovský kraj";430;10416;561;10977;NA;103158;991;2021-01-08;-208617
2021-01-07;"Prešovský kraj";268;7432;622;8054;NA;103158;890;2021-01-07;-209608
2021-01-06;"Prešovský kraj";315;1484;134;1618;NA;103158;449;2021-01-06;-210498
2021-01-05;"Prešovský kraj";655;11275;976;12251;NA;103158;1631;2021-01-05;-210947
2021-01-04;"Prešovský kraj";371;16845;1789;18634;NA;103158;2160;2021-01-04;-212578
2021-01-03;"Prešovský kraj";89;459;41;500;NA;103158;130;2021-01-03;-214738
2021-01-02;"Prešovský kraj";65;1556;160;1716;NA;103158;225;2021-01-02;-214868
2021-01-01;"Prešovský kraj";174;956;71;1027;NA;103158;245;2021-01-01;-215093
2020-12-31;"Prešovský kraj";640;11959;783;12742;NA;103158;1423;2020-12-31;-215338
2020-12-30;"Prešovský kraj";729;8729;769;9498;NA;103158;1498;2020-12-30;-216761
2020-12-29;"Prešovský kraj";435;9273;949;10222;NA;103158;1384;2020-12-29;-218259
2020-12-28;"Prešovský kraj";393;9046;1079;10125;NA;103158;1472;2020-12-28;-219643
2020-12-27;"Prešovský kraj";40;613;45;658;NA;103158;85;2020-12-27;-221115
2020-12-26;"Prešovský kraj";64;176;12;188;NA;103158;76;2020-12-26;-221200
2020-12-25;"Prešovský kraj";208;274;11;285;NA;103158;219;2020-12-25;-221276
2020-12-24;"Prešovský kraj";452;1214;85;1299;NA;103158;537;2020-12-24;-221495
2020-12-23;"Prešovský kraj";361;11006;618;11624;NA;103158;979;2020-12-23;-222032
2020-12-22;"Prešovský kraj";439;9023;695;9718;NA;103158;1134;2020-12-22;-223011
2020-12-21;"Prešovský kraj";432;9577;847;10424;NA;103158;1279;2020-12-21;-224145
2020-12-20;"Prešovský kraj";184;396;20;416;NA;103158;204;2020-12-20;-225424
2020-12-19;"Prešovský kraj";276;1658;151;1809;NA;103158;427;2020-12-19;-225628
2020-12-18;"Prešovský kraj";396;8246;566;8812;NA;103158;962;2020-12-18;-226055
2020-12-17;"Prešovský kraj";427;10505;866;11371;NA;103158;1293;2020-12-17;-227017
2020-12-16;"Prešovský kraj";466;5613;473;6086;NA;103158;939;2020-12-16;-228310
2020-12-15;"Prešovský kraj";411;5406;574;5980;NA;103158;985;2020-12-15;-229249
2020-12-14;"Prešovský kraj";334;5538;477;6015;NA;103158;811;2020-12-14;-230234
2020-12-13;"Prešovský kraj";89;29;8;37;NA;103158;97;2020-12-13;-231045
2020-12-12;"Prešovský kraj";319;2474;166;2640;NA;103158;485;2020-12-12;-231142
2020-12-11;"Prešovský kraj";560;5602;402;6004;NA;103158;962;2020-12-11;-231627
2020-12-10;"Prešovský kraj";337;5019;423;5442;NA;103158;760;2020-12-10;-232589
2020-12-09;"Prešovský kraj";358;4357;314;4671;NA;103158;672;2020-12-09;-233349
2020-12-08;"Prešovský kraj";350;6629;651;7280;NA;103158;1001;2020-12-08;-234021
2020-12-07;"Prešovský kraj";309;4345;327;4672;NA;103158;636;2020-12-07;-235022
2020-12-06;"Prešovský kraj";59;655;26;681;NA;103158;85;2020-12-06;-235658
2020-12-05;"Prešovský kraj";218;984;87;1071;NA;103158;305;2020-12-05;-235743
2020-12-04;"Prešovský kraj";352;5070;293;5363;NA;103158;645;2020-12-04;-236048
2020-12-03;"Prešovský kraj";284;2456;179;2635;NA;103158;463;2020-12-03;-236693
2020-12-02;"Prešovský kraj";232;2830;225;3055;NA;103158;457;2020-12-02;-237156
2020-12-01;"Prešovský kraj";281;1884;196;2080;NA;103158;477;2020-12-01;-237613
2020-11-30;"Prešovský kraj";196;5333;97;5430;NA;103158;293;2020-11-30;-238090
2020-11-29;"Prešovský kraj";27;379;42;421;NA;103158;69;2020-11-29;-238383
2020-11-28;"Prešovský kraj";199;772;77;849;NA;103158;276;2020-11-28;-238452
2020-11-27;"Prešovský kraj";232;2350;130;2480;NA;103158;362;2020-11-27;-238728
2020-11-26;"Prešovský kraj";263;3014;329;3343;NA;103158;592;2020-11-26;-239090
2020-11-25;"Prešovský kraj";302;2174;103;2277;NA;103158;405;2020-11-25;-239682
2020-11-24;"Prešovský kraj";365;1777;156;1933;NA;103158;521;2020-11-24;-240087
2020-11-23;"Prešovský kraj";164;1099;60;1159;NA;103158;224;2020-11-23;-240608
2020-11-22;"Prešovský kraj";46;44;1;45;NA;103158;47;2020-11-22;-240832
2020-11-21;"Prešovský kraj";205;754;62;816;NA;103158;267;2020-11-21;-240879
2020-11-20;"Prešovský kraj";363;2258;102;2360;NA;103158;465;2020-11-20;-241146
2020-11-19;"Prešovský kraj";359;2096;238;2334;NA;103158;597;2020-11-19;-241611
2020-11-18;"Prešovský kraj";270;488;43;531;NA;103158;313;2020-11-18;-242208
2020-11-17;"Prešovský kraj";347;205;23;228;NA;103158;370;2020-11-17;-242521
2020-11-16;"Prešovský kraj";226;540;58;598;NA;103158;284;2020-11-16;-242891
2020-11-15;"Prešovský kraj";186;39;4;43;NA;103158;190;2020-11-15;-243175
2020-11-14;"Prešovský kraj";261;54;4;58;NA;103158;265;2020-11-14;-243365
2020-11-13;"Prešovský kraj";395;166;8;174;NA;103158;403;2020-11-13;-243630
2020-11-12;"Prešovský kraj";397;229;50;279;NA;103158;447;2020-11-12;-244033
2020-11-11;"Prešovský kraj";516;161;15;176;NA;103158;531;2020-11-11;-244480
2020-11-10;"Prešovský kraj";437;197;9;206;NA;103158;446;2020-11-10;-245011
2020-11-09;"Prešovský kraj";190;4110;945;5055;NA;103158;1135;2020-11-09;-245457
2020-11-08;"Prešovský kraj";97;2817;32;2849;NA;103158;129;2020-11-08;-246592
2020-11-07;"Prešovský kraj";416;8578;81;8659;NA;103158;497;2020-11-07;-246721
2020-11-06;"Prešovský kraj";520;4791;76;4867;NA;103158;596;2020-11-06;-247218
2020-11-05;"Prešovský kraj";397;180;5;185;NA;103158;402;2020-11-05;-247814
2020-11-04;"Prešovský kraj";350;807;8;815;NA;103158;358;2020-11-04;-248216
2020-11-03;"Prešovský kraj";565;98;12;110;NA;103158;577;2020-11-03;-248574
2020-11-02;"Prešovský kraj";203;4158;1004;5162;NA;103158;1207;2020-11-02;-249151
2020-11-01;"Prešovský kraj";386;2906;53;2959;NA;103158;439;2020-11-01;-250358
2020-10-31;"Prešovský kraj";315;10497;170;10667;NA;103158;485;2020-10-31;-250797
2020-10-30;"Prešovský kraj";552;2949;65;3014;NA;103158;617;2020-10-30;-251282
2020-10-29;"Prešovský kraj";594;301;38;339;NA;103158;632;2020-10-29;-251899
2020-10-28;"Prešovský kraj";617;291;46;337;NA;103158;663;2020-10-28;-252531
2020-10-27;"Prešovský kraj";656;268;34;302;NA;103158;690;2020-10-27;-253194
2020-10-26;"Prešovský kraj";137;363;57;420;NA;103158;194;2020-10-26;-253884
2020-10-25;"Prešovský kraj";237;346;11;357;NA;103158;248;2020-10-25;-254078
2020-10-24;"Prešovský kraj";719;200;12;212;NA;103158;731;2020-10-24;-254326
2020-10-23;"Prešovský kraj";750;218;8;226;NA;103158;758;2020-10-23;-255057
2020-10-22;"Prešovský kraj";646;396;30;426;NA;103158;676;2020-10-22;-255815
2020-10-21;"Prešovský kraj";383;58;8;66;NA;103158;391;2020-10-21;-256491
2020-10-20;"Prešovský kraj";493;65;7;72;NA;103158;500;2020-10-20;-256882
2020-10-19;"Prešovský kraj";140;235;15;250;NA;103158;155;2020-10-19;-257382
2020-10-18;"Prešovský kraj";209;0;0;0;NA;103158;209;2020-10-18;-257537
2020-10-17;"Prešovský kraj";342;0;0;0;NA;103158;342;2020-10-17;-257746
2020-10-16;"Prešovský kraj";388;57;3;60;NA;103158;391;2020-10-16;-258088
2020-10-15;"Prešovský kraj";435;85;18;103;NA;103158;453;2020-10-15;-258479
2020-10-14;"Prešovský kraj";451;54;10;64;NA;103158;461;2020-10-14;-258932
2020-10-13;"Prešovský kraj";264;50;6;56;NA;103158;270;2020-10-13;-259393
2020-10-12;"Prešovský kraj";214;334;35;369;NA;103158;249;2020-10-12;-259663
2020-10-11;"Prešovský kraj";127;0;0;0;NA;103158;127;2020-10-11;-259912
2020-10-10;"Prešovský kraj";248;0;0;0;NA;103158;248;2020-10-10;-260039
2020-10-09;"Prešovský kraj";406;0;0;0;NA;103158;406;2020-10-09;-260287
2020-10-08;"Prešovský kraj";245;0;0;0;NA;103158;245;2020-10-08;-260693
2020-10-07;"Prešovský kraj";244;0;0;0;NA;103158;244;2020-10-07;-260938
2020-10-06;"Prešovský kraj";166;0;0;0;NA;103158;166;2020-10-06;-261182
2020-10-05;"Prešovský kraj";84;0;0;0;NA;103158;84;2020-10-05;-261348
2020-10-04;"Prešovský kraj";118;0;0;0;NA;103158;118;2020-10-04;-261432
2020-10-03;"Prešovský kraj";204;0;0;0;NA;103158;204;2020-10-03;-261550
2020-10-02;"Prešovský kraj";149;0;0;0;NA;103158;149;2020-10-02;-261754
2020-10-01;"Prešovský kraj";136;0;0;0;NA;103158;136;2020-10-01;-261903
2020-09-30;"Prešovský kraj";121;0;0;0;NA;103158;121;2020-09-30;-262039
2020-09-29;"Prešovský kraj";156;0;0;0;NA;103158;156;2020-09-29;-262160
2020-09-28;"Prešovský kraj";51;0;0;0;NA;103158;51;2020-09-28;-262316
2020-09-27;"Prešovský kraj";10;0;0;0;NA;103158;10;2020-09-27;-262367
2020-09-26;"Prešovský kraj";72;0;0;0;NA;103158;72;2020-09-26;-262377
2020-09-25;"Prešovský kraj";91;0;0;0;NA;103158;91;2020-09-25;-262449
2020-09-24;"Prešovský kraj";52;0;0;0;NA;103158;52;2020-09-24;-262540
2020-09-23;"Prešovský kraj";55;0;0;0;NA;103158;55;2020-09-23;-262592
2020-09-22;"Prešovský kraj";29;0;0;0;NA;103158;29;2020-09-22;-262647
2020-09-21;"Prešovský kraj";14;0;0;0;NA;103158;14;2020-09-21;-262676
2020-09-20;"Prešovský kraj";5;0;0;0;NA;103158;5;2020-09-20;-262690
2020-09-19;"Prešovský kraj";12;0;0;0;NA;103158;12;2020-09-19;-262695
2020-09-18;"Prešovský kraj";29;0;0;0;NA;103158;29;2020-09-18;-262707
2020-09-17;"Prešovský kraj";25;0;0;0;NA;103158;25;2020-09-17;-262736
2020-09-16;"Prešovský kraj";8;0;0;0;NA;103158;8;2020-09-16;-262761
2020-09-15;"Prešovský kraj";10;0;0;0;NA;103158;10;2020-09-15;-262769
2020-09-14;"Prešovský kraj";47;0;0;0;NA;103158;47;2020-09-14;-262779
2020-09-13;"Prešovský kraj";3;0;0;0;NA;103158;3;2020-09-13;-262826
2020-09-12;"Prešovský kraj";4;0;0;0;NA;103158;4;2020-09-12;-262829
2020-09-11;"Prešovský kraj";15;0;0;0;NA;103158;15;2020-09-11;-262833
2020-09-10;"Prešovský kraj";10;0;0;0;NA;103158;10;2020-09-10;-262848
2020-09-09;"Prešovský kraj";21;0;0;0;NA;103158;21;2020-09-09;-262858
2020-09-08;"Prešovský kraj";23;0;0;0;NA;103158;23;2020-09-08;-262879
2020-09-07;"Prešovský kraj";5;0;0;0;NA;103158;5;2020-09-07;-262902
2020-09-06;"Prešovský kraj";3;0;0;0;NA;103158;3;2020-09-06;-262907
2020-09-05;"Prešovský kraj";7;0;0;0;NA;103158;7;2020-09-05;-262910
2020-09-04;"Prešovský kraj";24;0;0;0;NA;103158;24;2020-09-04;-262917
2020-09-03;"Prešovský kraj";8;0;0;0;NA;103158;8;2020-09-03;-262941
2020-09-02;"Prešovský kraj";9;0;0;0;NA;103158;9;2020-09-02;-262949
2020-09-01;"Prešovský kraj";6;0;0;0;NA;103158;6;2020-09-01;-262958
2020-08-31;"Prešovský kraj";3;0;0;0;NA;103158;3;2020-08-31;-262964
2020-08-30;"Prešovský kraj";6;0;0;0;NA;103158;6;2020-08-30;-262967
2020-08-29;"Prešovský kraj";4;0;0;0;NA;103158;4;2020-08-29;-262973
2020-08-28;"Prešovský kraj";6;0;0;0;NA;103158;6;2020-08-28;-262977
2020-08-27;"Prešovský kraj";7;0;0;0;NA;103158;7;2020-08-27;-262983
2020-08-26;"Prešovský kraj";22;0;0;0;NA;103158;22;2020-08-26;-262990
2020-08-25;"Prešovský kraj";1;0;0;0;NA;103158;1;2020-08-25;-263012
2020-08-24;"Prešovský kraj";5;0;0;0;NA;103158;5;2020-08-24;-263013
2020-08-23;"Prešovský kraj";3;0;0;0;NA;103158;3;2020-08-23;-263018
2020-08-22;"Prešovský kraj";3;0;0;0;NA;103158;3;2020-08-22;-263021
2020-08-21;"Prešovský kraj";11;0;0;0;NA;103158;11;2020-08-21;-263024
2020-08-20;"Prešovský kraj";8;0;0;0;NA;103158;8;2020-08-20;-263035
2020-08-19;"Prešovský kraj";8;0;0;0;NA;103158;8;2020-08-19;-263043
2020-08-18;"Prešovský kraj";6;0;0;0;NA;103158;6;2020-08-18;-263051
2020-08-17;"Prešovský kraj";1;0;0;0;NA;103158;1;2020-08-17;-263057
2020-08-16;"Prešovský kraj";0;0;0;0;NA;103158;0;2020-08-16;-263058
2020-08-15;"Prešovský kraj";8;0;0;0;NA;103158;8;2020-08-15;-263058
2020-08-14;"Prešovský kraj";6;0;0;0;NA;103158;6;2020-08-14;-263066
2020-08-13;"Prešovský kraj";8;0;0;0;NA;103158;8;2020-08-13;-263072
2020-08-12;"Prešovský kraj";19;0;0;0;NA;103158;19;2020-08-12;-263080
2020-08-11;"Prešovský kraj";3;0;0;0;NA;103158;3;2020-08-11;-263099
2020-08-10;"Prešovský kraj";0;0;0;0;NA;103158;0;2020-08-10;-263102
2020-08-09;"Prešovský kraj";0;0;0;0;NA;103158;0;2020-08-09;-263102
2020-08-08;"Prešovský kraj";2;0;0;0;NA;103158;2;2020-08-08;-263102
2020-08-07;"Prešovský kraj";6;0;0;0;NA;103158;6;2020-08-07;-263104
2020-08-06;"Prešovský kraj";2;0;0;0;NA;103158;2;2020-08-06;-263110
2020-08-05;"Prešovský kraj";8;0;0;0;NA;103158;8;2020-08-05;-263112
2020-08-04;"Prešovský kraj";5;0;0;0;NA;103158;5;2020-08-04;-263120
2020-08-03;"Prešovský kraj";4;0;0;0;NA;103158;4;2020-08-03;-263125
2020-08-02;"Prešovský kraj";6;0;0;0;NA;103158;6;2020-08-02;-263129
2020-08-01;"Prešovský kraj";0;0;0;0;NA;103158;0;2020-08-01;-263135
2020-07-31;"Prešovský kraj";2;0;0;0;NA;103158;2;2020-07-31;-263135
2020-07-30;"Prešovský kraj";6;0;0;0;NA;103158;6;2020-07-30;-263137
2020-07-29;"Prešovský kraj";5;0;0;0;NA;103158;5;2020-07-29;-263143
2020-07-28;"Prešovský kraj";0;0;0;0;NA;103158;0;2020-07-28;-263148
2020-07-27;"Prešovský kraj";1;0;0;0;NA;103158;1;2020-07-27;-263148
2020-07-26;"Prešovský kraj";1;0;0;0;NA;103158;1;2020-07-26;-263149
2020-07-25;"Prešovský kraj";21;0;0;0;NA;103158;21;2020-07-25;-263150
2020-07-24;"Prešovský kraj";1;0;0;0;NA;103158;1;2020-07-24;-263171
2020-07-23;"Prešovský kraj";5;0;0;0;NA;103158;5;2020-07-23;-263172
2020-07-22;"Prešovský kraj";1;0;0;0;NA;103158;1;2020-07-22;-263177
2020-07-21;"Prešovský kraj";2;0;0;0;NA;103158;2;2020-07-21;-263178
2020-07-20;"Prešovský kraj";1;0;0;0;NA;103158;1;2020-07-20;-263180
2020-07-19;"Prešovský kraj";0;0;0;0;NA;103158;0;2020-07-19;-263181
2020-07-18;"Prešovský kraj";0;0;0;0;NA;103158;0;2020-07-18;-263181
2020-07-17;"Prešovský kraj";3;0;0;0;NA;103158;3;2020-07-17;-263181
2020-07-16;"Prešovský kraj";1;0;0;0;NA;103158;1;2020-07-16;-263184
2020-07-15;"Prešovský kraj";5;0;0;0;NA;103158;5;2020-07-15;-263185
2020-07-14;"Prešovský kraj";5;0;0;0;NA;103158;5;2020-07-14;-263190
2020-07-13;"Prešovský kraj";1;0;0;0;NA;103158;1;2020-07-13;-263195
2020-07-12;"Prešovský kraj";1;0;0;0;NA;103158;1;2020-07-12;-263196
2020-07-11;"Prešovský kraj";6;0;0;0;NA;103158;6;2020-07-11;-263197
2020-07-10;"Prešovský kraj";5;0;0;0;NA;103158;5;2020-07-10;-263203
2020-07-09;"Prešovský kraj";2;0;0;0;NA;103158;2;2020-07-09;-263208
2020-07-08;"Prešovský kraj";14;0;0;0;NA;103158;14;2020-07-08;-263210
2020-07-07;"Prešovský kraj";2;0;0;0;NA;103158;2;2020-07-07;-263224
2020-07-06;"Prešovský kraj";0;0;0;0;NA;103158;0;2020-07-06;-263226
2020-07-05;"Prešovský kraj";0;0;0;0;NA;103158;0;2020-07-05;-263226
2020-07-04;"Prešovský kraj";1;0;0;0;NA;103158;1;2020-07-04;-263226
2020-07-03;"Prešovský kraj";3;0;0;0;NA;103158;3;2020-07-03;-263227
2020-07-02;"Prešovský kraj";0;0;0;0;NA;103158;0;2020-07-02;-263230
2020-07-01;"Prešovský kraj";0;0;0;0;NA;103158;0;2020-07-01;-263230
2020-06-30;"Prešovský kraj";7;0;0;0;NA;103158;7;2020-06-30;-263230
2020-06-29;"Prešovský kraj";0;0;0;0;NA;103158;0;2020-06-29;-263237
2020-06-28;"Prešovský kraj";0;0;0;0;NA;103158;0;2020-06-28;-263237
2020-06-27;"Prešovský kraj";3;0;0;0;NA;103158;3;2020-06-27;-263237
2020-06-26;"Prešovský kraj";3;0;0;0;NA;103158;3;2020-06-26;-263240
2020-06-25;"Prešovský kraj";0;0;0;0;NA;103158;0;2020-06-25;-263243
2020-06-24;"Prešovský kraj";4;0;0;0;NA;103158;4;2020-06-24;-263243
2020-06-23;"Prešovský kraj";0;0;0;0;NA;103158;0;2020-06-23;-263247
2020-06-22;"Prešovský kraj";0;0;0;0;NA;103158;0;2020-06-22;-263247
2020-06-21;"Prešovský kraj";0;0;0;0;NA;103158;0;2020-06-21;-263247
2020-06-20;"Prešovský kraj";0;0;0;0;NA;103158;0;2020-06-20;-263247
2020-06-19;"Prešovský kraj";1;0;0;0;NA;103158;1;2020-06-19;-263247
2020-06-18;"Prešovský kraj";0;0;0;0;NA;103158;0;2020-06-18;-263248
2020-06-17;"Prešovský kraj";0;0;0;0;NA;103158;0;2020-06-17;-263248
2020-06-16;"Prešovský kraj";6;0;0;0;NA;103158;6;2020-06-16;-263248
2020-06-14;"Prešovský kraj";0;0;0;0;NA;103158;0;2020-06-14;-263254
2020-06-13;"Prešovský kraj";0;0;0;0;NA;103158;0;2020-06-13;-263254
2020-06-12;"Prešovský kraj";1;0;0;0;NA;103158;1;2020-06-12;-263254
2020-06-11;"Prešovský kraj";0;0;0;0;NA;103158;0;2020-06-11;-263255
2020-06-10;"Prešovský kraj";0;0;0;0;NA;103158;0;2020-06-10;-263255
2020-06-09;"Prešovský kraj";0;0;0;0;NA;103158;0;2020-06-09;-263255
2020-06-08;"Prešovský kraj";0;0;0;0;NA;103158;0;2020-06-08;-263255
2020-06-07;"Prešovský kraj";0;0;0;0;NA;103158;0;2020-06-07;-263255
2020-06-05;"Prešovský kraj";0;0;0;0;NA;103158;0;2020-06-05;-263255
2020-06-03;"Prešovský kraj";0;0;0;0;NA;103158;0;2020-06-03;-263255
2020-06-02;"Prešovský kraj";1;0;0;0;NA;103158;1;2020-06-02;-263255
2020-05-31;"Prešovský kraj";1;0;0;0;NA;103158;1;2020-05-31;-263256
2020-05-29;"Prešovský kraj";0;0;0;0;NA;103158;0;2020-05-29;-263257
2020-05-27;"Prešovský kraj";0;0;0;0;NA;103158;0;2020-05-27;-263257
2020-05-26;"Prešovský kraj";0;0;0;0;NA;103158;0;2020-05-26;-263257
2020-05-25;"Prešovský kraj";0;0;0;0;NA;103158;0;2020-05-25;-263257
2020-05-24;"Prešovský kraj";0;0;0;0;NA;103158;0;2020-05-24;-263257
2020-05-23;"Prešovský kraj";0;0;0;0;NA;103158;0;2020-05-23;-263257
2020-05-22;"Prešovský kraj";0;0;0;0;NA;103158;0;2020-05-22;-263257
2020-05-21;"Prešovský kraj";1;0;0;0;NA;103158;1;2020-05-21;-263257
2020-05-20;"Prešovský kraj";0;0;0;0;NA;103158;0;2020-05-20;-263258
2020-05-19;"Prešovský kraj";0;0;0;0;NA;103158;0;2020-05-19;-263258
2020-05-17;"Prešovský kraj";0;0;0;0;NA;103158;0;2020-05-17;-263258
2020-05-16;"Prešovský kraj";0;0;0;0;NA;103158;0;2020-05-16;-263258
2020-05-15;"Prešovský kraj";0;0;0;0;NA;103158;0;2020-05-15;-263258
2020-05-14;"Prešovský kraj";0;0;0;0;NA;103158;0;2020-05-14;-263258
2020-05-13;"Prešovský kraj";1;0;0;0;NA;103158;1;2020-05-13;-263258
2020-05-12;"Prešovský kraj";0;0;0;0;NA;103158;0;2020-05-12;-263259
2020-05-11;"Prešovský kraj";1;0;0;0;NA;103158;1;2020-05-11;-263259
2020-05-09;"Prešovský kraj";0;0;0;0;NA;103158;0;2020-05-09;-263260
2020-05-07;"Prešovský kraj";0;0;0;0;NA;103158;0;2020-05-07;-263260
2020-05-06;"Prešovský kraj";0;0;0;0;NA;103158;0;2020-05-06;-263260
2020-05-05;"Prešovský kraj";1;0;0;0;NA;103158;1;2020-05-05;-263260
2020-05-04;"Prešovský kraj";0;0;0;0;NA;103158;0;2020-05-04;-263261
2020-05-03;"Prešovský kraj";0;0;0;0;NA;103158;0;2020-05-03;-263261
2020-05-02;"Prešovský kraj";0;0;0;0;NA;103158;0;2020-05-02;-263261
2020-05-01;"Prešovský kraj";2;0;0;0;NA;103158;2;2020-05-01;-263261
2020-04-30;"Prešovský kraj";0;0;0;0;NA;103158;0;2020-04-30;-263263
2020-04-29;"Prešovský kraj";1;0;0;0;NA;103158;1;2020-04-29;-263263
2020-04-28;"Prešovský kraj";1;0;0;0;NA;103158;1;2020-04-28;-263264
2020-04-27;"Prešovský kraj";2;0;0;0;NA;103158;2;2020-04-27;-263265
2020-04-26;"Prešovský kraj";0;0;0;0;NA;103158;0;2020-04-26;-263267
2020-04-25;"Prešovský kraj";0;0;0;0;NA;103158;0;2020-04-25;-263267
2020-04-24;"Prešovský kraj";0;0;0;0;NA;103158;0;2020-04-24;-263267
2020-04-23;"Prešovský kraj";2;0;0;0;NA;103158;2;2020-04-23;-263267
2020-04-22;"Prešovský kraj";11;0;0;0;NA;103158;11;2020-04-22;-263269
2020-04-21;"Prešovský kraj";12;0;0;0;NA;103158;12;2020-04-21;-263280
2020-04-20;"Prešovský kraj";2;0;0;0;NA;103158;2;2020-04-20;-263292
2020-04-19;"Prešovský kraj";4;0;0;0;NA;103158;4;2020-04-19;-263294
2020-04-18;"Prešovský kraj";1;0;0;0;NA;103158;1;2020-04-18;-263298
2020-04-17;"Prešovský kraj";4;0;0;0;NA;103158;4;2020-04-17;-263299
2020-04-16;"Prešovský kraj";9;0;0;0;NA;103158;9;2020-04-16;-263303
2020-04-15;"Prešovský kraj";21;0;0;0;NA;103158;21;2020-04-15;-263312
2020-04-14;"Prešovský kraj";1;0;0;0;NA;103158;1;2020-04-14;-263333
2020-04-13;"Prešovský kraj";2;0;0;0;NA;103158;2;2020-04-13;-263334
2020-04-12;"Prešovský kraj";6;0;0;0;NA;103158;6;2020-04-12;-263336
2020-04-11;"Prešovský kraj";4;0;0;0;NA;103158;4;2020-04-11;-263342
2020-04-10;"Prešovský kraj";0;0;0;0;NA;103158;0;2020-04-10;-263346
2020-04-09;"Prešovský kraj";1;0;0;0;NA;103158;1;2020-04-09;-263346
2020-04-08;"Prešovský kraj";0;0;0;0;NA;103158;0;2020-04-08;-263347
2020-04-07;"Prešovský kraj";7;0;0;0;NA;103158;7;2020-04-07;-263347
2020-04-06;"Prešovský kraj";10;0;0;0;NA;103158;10;2020-04-06;-263354
2020-04-05;"Prešovský kraj";13;0;0;0;NA;103158;13;2020-04-05;-263364
2020-04-04;"Prešovský kraj";1;0;0;0;NA;103158;1;2020-04-04;-263377
2020-04-03;"Prešovský kraj";4;0;0;0;NA;103158;4;2020-04-03;-263378
2020-04-02;"Prešovský kraj";6;0;0;0;NA;103158;6;2020-04-02;-263382
2020-04-01;"Prešovský kraj";6;0;0;0;NA;103158;6;2020-04-01;-263388
2020-03-31;"Prešovský kraj";6;0;0;0;NA;103158;6;2020-03-31;-263394
2020-03-30;"Prešovský kraj";2;0;0;0;NA;103158;2;2020-03-30;-263400
2020-03-29;"Prešovský kraj";2;0;0;0;NA;103158;2;2020-03-29;-263402
2020-03-28;"Prešovský kraj";2;0;0;0;NA;103158;2;2020-03-28;-263404
2020-03-27;"Prešovský kraj";1;0;0;0;NA;103158;1;2020-03-27;-263406
2020-03-26;"Prešovský kraj";8;0;0;0;NA;103158;8;2020-03-26;-263407
2020-03-25;"Prešovský kraj";1;0;0;0;NA;103158;1;2020-03-25;-263415
2020-03-24;"Prešovský kraj";4;0;0;0;NA;103158;4;2020-03-24;-263416
2020-03-23;"Prešovský kraj";0;0;0;0;NA;103158;0;2020-03-23;-263420
2020-03-22;"Prešovský kraj";1;0;0;0;NA;103158;1;2020-03-22;-263420
2020-03-21;"Prešovský kraj";2;0;0;0;NA;103158;2;2020-03-21;-263421
2020-03-20;"Prešovský kraj";3;0;0;0;NA;103158;3;2020-03-20;-263423
2020-03-19;"Prešovský kraj";2;0;0;0;NA;103158;2;2020-03-19;-263426
2020-03-18;"Prešovský kraj";1;0;0;0;NA;103158;1;2020-03-18;-263428
2020-03-17;"Prešovský kraj";1;0;0;0;NA;103158;1;2020-03-17;-263429
2020-03-16;"Prešovský kraj";4;0;0;0;NA;103158;4;2020-03-16;-263430
2020-03-15;"Prešovský kraj";0;0;0;0;NA;103158;0;2020-03-15;-263434
2020-03-14;"Prešovský kraj";1;0;0;0;NA;103158;1;2020-03-14;-263434
2020-03-13;"Prešovský kraj";0;0;0;0;NA;103158;0;2020-03-13;-263435
2020-03-12;"Prešovský kraj";0;0;0;0;NA;103158;0;2020-03-12;-263435
2020-03-11;"Prešovský kraj";0;0;0;0;NA;103158;0;2020-03-11;-263435
2020-03-09;"Prešovský kraj";0;0;0;0;NA;103158;0;2020-03-09;-263435
2020-03-08;"Prešovský kraj";0;0;0;0;NA;103158;0;2020-03-08;-263435
2020-03-07;"Prešovský kraj";0;0;0;0;NA;103158;0;2020-03-07;-263435
2020-03-06;"Prešovský kraj";0;0;0;0;NA;103158;0;2020-03-06;-263435
2022-06-26;"Trenčiansky kraj";1;2;2;4;NA;90391;3;2022-06-26;90391
2022-06-25;"Trenčiansky kraj";15;3;0;3;NA;90391;15;2022-06-25;90388
2022-06-24;"Trenčiansky kraj";36;34;5;39;NA;90391;41;2022-06-24;90373
2022-06-23;"Trenčiansky kraj";17;84;7;91;NA;90391;24;2022-06-23;90332
2022-06-22;"Trenčiansky kraj";30;59;9;68;NA;90391;39;2022-06-22;90308
2022-06-21;"Trenčiansky kraj";21;57;6;63;NA;90391;27;2022-06-21;90269
2022-06-20;"Trenčiansky kraj";24;68;12;80;NA;90391;36;2022-06-20;90242
2022-06-19;"Trenčiansky kraj";2;37;4;41;NA;90391;6;2022-06-19;90206
2022-06-18;"Trenčiansky kraj";4;26;1;27;NA;90391;5;2022-06-18;90200
2022-06-17;"Trenčiansky kraj";16;73;3;76;NA;90391;19;2022-06-17;90195
2022-06-16;"Trenčiansky kraj";13;77;2;79;NA;90391;15;2022-06-16;90176
2022-06-15;"Trenčiansky kraj";20;79;2;81;NA;90391;22;2022-06-15;90161
2022-06-14;"Trenčiansky kraj";13;72;5;77;NA;90391;18;2022-06-14;90139
2022-06-13;"Trenčiansky kraj";20;80;8;88;NA;90391;28;2022-06-13;90121
2022-06-12;"Trenčiansky kraj";0;42;2;44;NA;90391;2;2022-06-12;90093
2022-06-11;"Trenčiansky kraj";6;26;2;28;NA;90391;8;2022-06-11;90091
2022-06-10;"Trenčiansky kraj";19;66;4;70;NA;90391;23;2022-06-10;90083
2022-06-09;"Trenčiansky kraj";14;58;4;62;NA;90391;18;2022-06-09;90060
2022-06-08;"Trenčiansky kraj";20;91;6;97;NA;90391;26;2022-06-08;90042
2022-06-07;"Trenčiansky kraj";18;77;8;85;NA;90391;26;2022-06-07;90016
2022-06-06;"Trenčiansky kraj";23;93;14;107;NA;90391;37;2022-06-06;89990
2022-06-05;"Trenčiansky kraj";0;316;20;336;NA;90391;20;2022-06-05;89953
2022-06-04;"Trenčiansky kraj";10;31;1;32;NA;90391;11;2022-06-04;89933
2022-06-03;"Trenčiansky kraj";15;71;8;79;NA;90391;23;2022-06-03;89922
2022-06-02;"Trenčiansky kraj";14;70;3;73;NA;90391;17;2022-06-02;89899
2022-06-01;"Trenčiansky kraj";12;118;7;125;NA;90391;19;2022-06-01;89882
2022-05-31;"Trenčiansky kraj";12;147;3;150;NA;90391;15;2022-05-31;89863
2022-05-30;"Trenčiansky kraj";13;212;7;219;NA;90391;20;2022-05-30;89848
2022-05-29;"Trenčiansky kraj";1;61;2;63;NA;90391;3;2022-05-29;89828
2022-05-28;"Trenčiansky kraj";3;30;0;30;NA;90391;3;2022-05-28;89825
2022-05-27;"Trenčiansky kraj";15;205;10;215;NA;90391;25;2022-05-27;89822
2022-05-26;"Trenčiansky kraj";21;83;6;89;NA;90391;27;2022-05-26;89797
2022-05-25;"Trenčiansky kraj";9;144;10;154;NA;90391;19;2022-05-25;89770
2022-05-24;"Trenčiansky kraj";21;165;5;170;NA;90391;26;2022-05-24;89751
2022-05-23;"Trenčiansky kraj";15;217;11;228;NA;90391;26;2022-05-23;89725
2022-05-22;"Trenčiansky kraj";1;55;3;58;NA;90391;4;2022-05-22;89699
2022-05-21;"Trenčiansky kraj";10;63;5;68;NA;90391;15;2022-05-21;89695
2022-05-20;"Trenčiansky kraj";26;157;12;169;NA;90391;38;2022-05-20;89680
2022-05-19;"Trenčiansky kraj";46;159;9;168;NA;90391;55;2022-05-19;89642
2022-05-18;"Trenčiansky kraj";24;169;9;178;NA;90391;33;2022-05-18;89587
2022-05-17;"Trenčiansky kraj";31;152;8;160;NA;90391;39;2022-05-17;89554
2022-05-16;"Trenčiansky kraj";19;235;20;255;NA;90391;39;2022-05-16;89515
2022-05-15;"Trenčiansky kraj";1;64;0;64;NA;90391;1;2022-05-15;89476
2022-05-14;"Trenčiansky kraj";31;63;4;67;NA;90391;35;2022-05-14;89475
2022-05-13;"Trenčiansky kraj";24;174;12;186;NA;90391;36;2022-05-13;89440
2022-05-12;"Trenčiansky kraj";29;189;13;202;NA;90391;42;2022-05-12;89404
2022-05-11;"Trenčiansky kraj";30;166;14;180;NA;90391;44;2022-05-11;89362
2022-05-10;"Trenčiansky kraj";46;171;19;190;NA;90391;65;2022-05-10;89318
2022-05-09;"Trenčiansky kraj";39;289;21;310;NA;90391;60;2022-05-09;89253
2022-05-08;"Trenčiansky kraj";3;82;7;89;NA;90391;10;2022-05-08;89193
2022-05-07;"Trenčiansky kraj";22;72;5;77;NA;90391;27;2022-05-07;89183
2022-05-06;"Trenčiansky kraj";52;297;17;314;NA;90391;69;2022-05-06;89156
2022-05-05;"Trenčiansky kraj";53;149;8;157;NA;90391;61;2022-05-05;89087
2022-05-04;"Trenčiansky kraj";43;247;12;259;NA;90391;55;2022-05-04;89026
2022-05-03;"Trenčiansky kraj";79;207;15;222;NA;90391;94;2022-05-03;88971
2022-05-02;"Trenčiansky kraj";57;585;19;604;NA;90391;76;2022-05-02;88877
2022-05-01;"Trenčiansky kraj";14;162;5;167;NA;90391;19;2022-05-01;88801
2022-04-30;"Trenčiansky kraj";75;173;4;177;NA;90391;79;2022-04-30;88782
2022-04-29;"Trenčiansky kraj";106;273;16;289;NA;90391;122;2022-04-29;88703
2022-04-28;"Trenčiansky kraj";87;502;12;514;NA;90391;99;2022-04-28;88581
2022-04-27;"Trenčiansky kraj";115;408;34;442;NA;90391;149;2022-04-27;88482
2022-04-26;"Trenčiansky kraj";151;375;10;385;NA;90391;161;2022-04-26;88333
2022-04-25;"Trenčiansky kraj";106;611;29;640;NA;90391;135;2022-04-25;88172
2022-04-24;"Trenčiansky kraj";32;215;13;228;NA;90391;45;2022-04-24;88037
2022-04-23;"Trenčiansky kraj";104;210;11;221;NA;90391;115;2022-04-23;87992
2022-04-22;"Trenčiansky kraj";122;456;32;488;NA;90391;154;2022-04-22;87877
2022-04-21;"Trenčiansky kraj";191;516;18;534;NA;90391;209;2022-04-21;87723
2022-04-20;"Trenčiansky kraj";269;460;23;483;NA;90391;292;2022-04-20;87514
2022-04-19;"Trenčiansky kraj";180;802;39;841;NA;90391;219;2022-04-19;87222
2022-04-18;"Trenčiansky kraj";107;242;15;257;NA;90391;122;2022-04-18;87003
2022-04-17;"Trenčiansky kraj";154;314;14;328;NA;90391;168;2022-04-17;86881
2022-04-16;"Trenčiansky kraj";51;297;10;307;NA;90391;61;2022-04-16;86713
2022-04-15;"Trenčiansky kraj";71;313;12;325;NA;90391;83;2022-04-15;86652
2022-04-14;"Trenčiansky kraj";235;702;36;738;NA;90391;271;2022-04-14;86569
2022-04-13;"Trenčiansky kraj";288;512;39;551;NA;90391;327;2022-04-13;86298
2022-04-12;"Trenčiansky kraj";293;744;52;796;NA;90391;345;2022-04-12;85971
2022-04-11;"Trenčiansky kraj";349;634;61;695;NA;90391;410;2022-04-11;85626
2022-04-10;"Trenčiansky kraj";110;440;28;468;NA;90391;138;2022-04-10;85216
2022-04-09;"Trenčiansky kraj";234;269;24;293;NA;90391;258;2022-04-09;85078
2022-04-08;"Trenčiansky kraj";301;475;27;502;NA;90391;328;2022-04-08;84820
2022-04-07;"Trenčiansky kraj";381;592;68;660;NA;90391;449;2022-04-07;84492
2022-04-06;"Trenčiansky kraj";416;680;78;758;NA;90391;494;2022-04-06;84043
2022-04-05;"Trenčiansky kraj";499;614;65;679;NA;90391;564;2022-04-05;83549
2022-04-04;"Trenčiansky kraj";468;948;95;1043;NA;90391;563;2022-04-04;82985
2022-04-03;"Trenčiansky kraj";127;373;46;419;NA;90391;173;2022-04-03;82422
2022-04-02;"Trenčiansky kraj";368;404;59;463;NA;90391;427;2022-04-02;82249
2022-04-01;"Trenčiansky kraj";510;630;65;695;NA;90391;575;2022-04-01;81822
2022-03-31;"Trenčiansky kraj";520;1013;97;1110;NA;90391;617;2022-03-31;81247
2022-03-30;"Trenčiansky kraj";706;1494;87;1581;NA;90391;793;2022-03-30;80630
2022-03-29;"Trenčiansky kraj";682;1077;97;1174;NA;90391;779;2022-03-29;79837
2022-03-28;"Trenčiansky kraj";673;1727;140;1867;NA;90391;813;2022-03-28;79058
2022-03-27;"Trenčiansky kraj";167;596;86;682;NA;90391;253;2022-03-27;78245
2022-03-26;"Trenčiansky kraj";513;395;43;438;NA;90391;556;2022-03-26;77992
2022-03-25;"Trenčiansky kraj";534;937;93;1030;NA;90391;627;2022-03-25;77436
2022-03-24;"Trenčiansky kraj";712;1266;106;1372;NA;90391;818;2022-03-24;76809
2022-03-23;"Trenčiansky kraj";903;1047;97;1144;NA;90391;1000;2022-03-23;75991
2022-03-22;"Trenčiansky kraj";918;1078;116;1194;NA;90391;1034;2022-03-22;74991
2022-03-21;"Trenčiansky kraj";745;1753;219;1972;NA;90391;964;2022-03-21;73957
2022-03-20;"Trenčiansky kraj";334;826;89;915;NA;90391;423;2022-03-20;72993
2022-03-19;"Trenčiansky kraj";560;510;77;587;NA;90391;637;2022-03-19;72570
2022-03-18;"Trenčiansky kraj";884;972;135;1107;NA;90391;1019;2022-03-18;71933
2022-03-17;"Trenčiansky kraj";863;1156;137;1293;NA;90391;1000;2022-03-17;70914
2022-03-16;"Trenčiansky kraj";1147;1303;129;1432;NA;90391;1276;2022-03-16;69914
2022-03-15;"Trenčiansky kraj";1054;1325;124;1449;NA;90391;1178;2022-03-15;68638
2022-03-14;"Trenčiansky kraj";934;2642;273;2915;NA;90391;1207;2022-03-14;67460
2022-03-13;"Trenčiansky kraj";373;698;97;795;NA;90391;470;2022-03-13;66253
2022-03-12;"Trenčiansky kraj";674;550;94;644;NA;90391;768;2022-03-12;65783
2022-03-11;"Trenčiansky kraj";1131;1379;222;1601;NA;90391;1353;2022-03-11;65015
2022-03-10;"Trenčiansky kraj";1087;1363;226;1589;NA;90391;1313;2022-03-10;63662
2022-03-09;"Trenčiansky kraj";1515;1517;240;1757;NA;90391;1755;2022-03-09;62349
2022-03-08;"Trenčiansky kraj";1059;1755;253;2008;NA;90391;1312;2022-03-08;60594
2022-03-07;"Trenčiansky kraj";1079;2457;360;2817;NA;90391;1439;2022-03-07;59282
2022-03-06;"Trenčiansky kraj";354;832;134;966;NA;90391;488;2022-03-06;57843
2022-03-05;"Trenčiansky kraj";583;700;138;838;NA;90391;721;2022-03-05;57355
2022-03-04;"Trenčiansky kraj";1125;1337;210;1547;NA;90391;1335;2022-03-04;56634
2022-03-03;"Trenčiansky kraj";1346;1710;223;1933;NA;90391;1569;2022-03-03;55299
2022-03-02;"Trenčiansky kraj";1345;1739;245;1984;NA;90391;1590;2022-03-02;53730
2022-03-01;"Trenčiansky kraj";1409;1805;309;2114;NA;90391;1718;2022-03-01;52140
2022-02-28;"Trenčiansky kraj";1390;2932;468;3400;NA;90391;1858;2022-02-28;50422
2022-02-27;"Trenčiansky kraj";573;1043;218;1261;NA;90391;791;2022-02-27;48564
2022-02-26;"Trenčiansky kraj";934;784;147;931;NA;90391;1081;2022-02-26;47773
2022-02-25;"Trenčiansky kraj";1460;1788;341;2129;NA;90391;1801;2022-02-25;46692
2022-02-24;"Trenčiansky kraj";1372;2468;309;2777;NA;90391;1681;2022-02-24;44891
2022-02-23;"Trenčiansky kraj";1677;2084;322;2406;NA;90391;1999;2022-02-23;43210
2022-02-22;"Trenčiansky kraj";2073;2270;451;2721;NA;90391;2524;2022-02-22;41211
2022-02-21;"Trenčiansky kraj";2172;4194;645;4839;NA;90391;2817;2022-02-21;38687
2022-02-20;"Trenčiansky kraj";1079;1436;322;1758;NA;90391;1401;2022-02-20;35870
2022-02-19;"Trenčiansky kraj";1168;1008;244;1252;NA;90391;1412;2022-02-19;34469
2022-02-18;"Trenčiansky kraj";2456;2369;477;2846;NA;90391;2933;2022-02-18;33057
2022-02-17;"Trenčiansky kraj";2090;2733;427;3160;NA;90391;2517;2022-02-17;30124
2022-02-16;"Trenčiansky kraj";2928;2478;512;2990;NA;90391;3440;2022-02-16;27607
2022-02-15;"Trenčiansky kraj";2372;2603;572;3175;NA;90391;2944;2022-02-15;24167
2022-02-14;"Trenčiansky kraj";2401;4489;728;5217;NA;90391;3129;2022-02-14;21223
2022-02-13;"Trenčiansky kraj";1357;1777;454;2231;NA;90391;1811;2022-02-13;18094
2022-02-12;"Trenčiansky kraj";1802;1448;277;1725;NA;90391;2079;2022-02-12;16283
2022-02-11;"Trenčiansky kraj";2863;2567;495;3062;NA;90391;3358;2022-02-11;14204
2022-02-10;"Trenčiansky kraj";2853;2717;504;3221;NA;90391;3357;2022-02-10;10846
2022-02-09;"Trenčiansky kraj";2788;4356;600;4956;NA;90391;3388;2022-02-09;7489
2022-02-08;"Trenčiansky kraj";2592;3182;660;3842;NA;90391;3252;2022-02-08;4101
2022-02-07;"Trenčiansky kraj";2787;5303;981;6284;NA;90391;3768;2022-02-07;849
2022-02-06;"Trenčiansky kraj";1431;2181;472;2653;NA;90391;1903;2022-02-06;-2919
2022-02-05;"Trenčiansky kraj";1458;1689;323;2012;NA;90391;1781;2022-02-05;-4822
2022-02-04;"Trenčiansky kraj";2480;3226;524;3750;NA;90391;3004;2022-02-04;-6603
2022-02-03;"Trenčiansky kraj";2391;3566;500;4066;NA;90391;2891;2022-02-03;-9607
2022-02-02;"Trenčiansky kraj";2486;4591;602;5193;NA;90391;3088;2022-02-02;-12498
2022-02-01;"Trenčiansky kraj";2359;3754;552;4306;NA;90391;2911;2022-02-01;-15586
2022-01-31;"Trenčiansky kraj";1823;7493;752;8245;NA;90391;2575;2022-01-31;-18497
2022-01-30;"Trenčiansky kraj";680;2463;319;2782;NA;90391;999;2022-01-30;-21072
2022-01-29;"Trenčiansky kraj";1227;1772;227;1999;NA;90391;1454;2022-01-29;-22071
2022-01-28;"Trenčiansky kraj";1709;3747;366;4113;NA;90391;2075;2022-01-28;-23525
2022-01-27;"Trenčiansky kraj";1533;3562;368;3930;NA;90391;1901;2022-01-27;-25600
2022-01-26;"Trenčiansky kraj";1415;4674;356;5030;NA;90391;1771;2022-01-26;-27501
2022-01-25;"Trenčiansky kraj";1553;3307;299;3606;NA;90391;1852;2022-01-25;-29272
2022-01-24;"Trenčiansky kraj";755;7090;328;7418;NA;90391;1083;2022-01-24;-31124
2022-01-23;"Trenčiansky kraj";337;2409;179;2588;NA;90391;516;2022-01-23;-32207
2022-01-22;"Trenčiansky kraj";683;1675;103;1778;NA;90391;786;2022-01-22;-32723
2022-01-21;"Trenčiansky kraj";576;3522;174;3696;NA;90391;750;2022-01-21;-33509
2022-01-20;"Trenčiansky kraj";710;2713;137;2850;NA;90391;847;2022-01-20;-34259
2022-01-19;"Trenčiansky kraj";621;3765;142;3907;NA;90391;763;2022-01-19;-35106
2022-01-18;"Trenčiansky kraj";579;3596;135;3731;NA;90391;714;2022-01-18;-35869
2022-01-17;"Trenčiansky kraj";380;6550;210;6760;NA;90391;590;2022-01-17;-36583
2022-01-16;"Trenčiansky kraj";89;2319;72;2391;NA;90391;161;2022-01-16;-37173
2022-01-15;"Trenčiansky kraj";194;1345;40;1385;NA;90391;234;2022-01-15;-37334
2022-01-14;"Trenčiansky kraj";189;2890;79;2969;NA;90391;268;2022-01-14;-37568
2022-01-13;"Trenčiansky kraj";134;3329;87;3416;NA;90391;221;2022-01-13;-37836
2022-01-12;"Trenčiansky kraj";346;3073;82;3155;NA;90391;428;2022-01-12;-38057
2022-01-11;"Trenčiansky kraj";300;3028;80;3108;NA;90391;380;2022-01-11;-38485
2022-01-10;"Trenčiansky kraj";218;7272;150;7422;NA;90391;368;2022-01-10;-38865
2022-01-09;"Trenčiansky kraj";40;2808;52;2860;NA;90391;92;2022-01-09;-39233
2022-01-08;"Trenčiansky kraj";267;1601;45;1646;NA;90391;312;2022-01-08;-39325
2022-01-07;"Trenčiansky kraj";334;2968;103;3071;NA;90391;437;2022-01-07;-39637
2022-01-06;"Trenčiansky kraj";75;1111;45;1156;NA;90391;120;2022-01-06;-40074
2022-01-05;"Trenčiansky kraj";496;3004;84;3088;NA;90391;580;2022-01-05;-40194
2022-01-04;"Trenčiansky kraj";521;3890;91;3981;NA;90391;612;2022-01-04;-40774
2022-01-03;"Trenčiansky kraj";357;5970;144;6114;NA;90391;501;2022-01-03;-41386
2022-01-02;"Trenčiansky kraj";179;2403;74;2477;NA;90391;253;2022-01-02;-41887
2022-01-01;"Trenčiansky kraj";4;526;28;554;NA;90391;32;2022-01-01;-42140
2021-12-31;"Trenčiansky kraj";443;1478;82;1560;NA;90391;525;2021-12-31;-42172
2021-12-30;"Trenčiansky kraj";370;2400;129;2529;NA;90391;499;2021-12-30;-42697
2021-12-29;"Trenčiansky kraj";429;2483;87;2570;NA;90391;516;2021-12-29;-43196
2021-12-28;"Trenčiansky kraj";609;2741;111;2852;NA;90391;720;2021-12-28;-43712
2021-12-27;"Trenčiansky kraj";546;3348;115;3463;NA;90391;661;2021-12-27;-44432
2021-12-26;"Trenčiansky kraj";147;1098;78;1176;NA;90391;225;2021-12-26;-45093
2021-12-25;"Trenčiansky kraj";52;503;27;530;NA;90391;79;2021-12-25;-45318
2021-12-24;"Trenčiansky kraj";176;652;37;689;NA;90391;213;2021-12-24;-45397
2021-12-23;"Trenčiansky kraj";532;2431;108;2539;NA;90391;640;2021-12-23;-45610
2021-12-22;"Trenčiansky kraj";512;2595;119;2714;NA;90391;631;2021-12-22;-46250
2021-12-21;"Trenčiansky kraj";694;3266;123;3389;NA;90391;817;2021-12-21;-46881
2021-12-20;"Trenčiansky kraj";488;6754;210;6964;NA;90391;698;2021-12-20;-47698
2021-12-19;"Trenčiansky kraj";202;2574;118;2692;NA;90391;320;2021-12-19;-48396
2021-12-18;"Trenčiansky kraj";438;1752;108;1860;NA;90391;546;2021-12-18;-48716
2021-12-17;"Trenčiansky kraj";427;4054;137;4191;NA;90391;564;2021-12-17;-49262
2021-12-16;"Trenčiansky kraj";649;3214;180;3394;NA;90391;829;2021-12-16;-49826
2021-12-15;"Trenčiansky kraj";791;4645;167;4812;NA;90391;958;2021-12-15;-50655
2021-12-14;"Trenčiansky kraj";885;3640;142;3782;NA;90391;1027;2021-12-14;-51613
2021-12-13;"Trenčiansky kraj";573;7458;256;7714;NA;90391;829;2021-12-13;-52640
2021-12-12;"Trenčiansky kraj";306;3156;156;3312;NA;90391;462;2021-12-12;-53469
2021-12-11;"Trenčiansky kraj";706;1876;138;2014;NA;90391;844;2021-12-11;-53931
2021-12-10;"Trenčiansky kraj";789;3694;201;3895;NA;90391;990;2021-12-10;-54775
2021-12-09;"Trenčiansky kraj";967;3897;203;4100;NA;90391;1170;2021-12-09;-55765
2021-12-08;"Trenčiansky kraj";1020;4475;203;4678;NA;90391;1223;2021-12-08;-56935
2021-12-07;"Trenčiansky kraj";1241;6281;217;6498;NA;90391;1458;2021-12-07;-58158
2021-12-06;"Trenčiansky kraj";751;8923;430;9353;NA;90391;1181;2021-12-06;-59616
2021-12-05;"Trenčiansky kraj";510;3610;210;3820;NA;90391;720;2021-12-05;-60797
2021-12-04;"Trenčiansky kraj";1058;2043;156;2199;NA;90391;1214;2021-12-04;-61517
2021-12-03;"Trenčiansky kraj";1272;4427;306;4733;NA;90391;1578;2021-12-03;-62731
2021-12-02;"Trenčiansky kraj";2007;4132;265;4397;NA;90391;2272;2021-12-02;-64309
2021-12-01;"Trenčiansky kraj";1000;4977;299;5276;NA;90391;1299;2021-12-01;-66581
2021-11-30;"Trenčiansky kraj";1086;4743;332;5075;NA;90391;1418;2021-11-30;-67880
2021-11-29;"Trenčiansky kraj";1165;10434;551;10985;NA;90391;1716;2021-11-29;-69298
2021-11-28;"Trenčiansky kraj";664;5566;308;5874;NA;90391;972;2021-11-28;-71014
2021-11-27;"Trenčiansky kraj";1080;2782;301;3083;NA;90391;1381;2021-11-27;-71986
2021-11-26;"Trenčiansky kraj";1238;4529;350;4879;NA;90391;1588;2021-11-26;-73367
2021-11-25;"Trenčiansky kraj";1018;3622;348;3970;NA;90391;1366;2021-11-25;-74955
2021-11-24;"Trenčiansky kraj";1362;5596;472;6068;NA;90391;1834;2021-11-24;-76321
2021-11-23;"Trenčiansky kraj";1140;3755;351;4106;NA;90391;1491;2021-11-23;-78155
2021-11-22;"Trenčiansky kraj";920;6562;568;7130;NA;90391;1488;2021-11-22;-79646
2021-11-21;"Trenčiansky kraj";413;3233;377;3610;NA;90391;790;2021-11-21;-81134
2021-11-20;"Trenčiansky kraj";914;2379;341;2720;NA;90391;1255;2021-11-20;-81924
2021-11-19;"Trenčiansky kraj";1261;3817;448;4265;NA;90391;1709;2021-11-19;-83179
2021-11-18;"Trenčiansky kraj";810;5085;529;5614;NA;90391;1339;2021-11-18;-84888
2021-11-17;"Trenčiansky kraj";796;1852;237;2089;NA;90391;1033;2021-11-17;-86227
2021-11-16;"Trenčiansky kraj";859;4095;403;4498;NA;90391;1262;2021-11-16;-87260
2021-11-15;"Trenčiansky kraj";720;5206;557;5763;NA;90391;1277;2021-11-15;-88522
2021-11-14;"Trenčiansky kraj";447;2462;343;2805;NA;90391;790;2021-11-14;-89799
2021-11-13;"Trenčiansky kraj";478;1879;254;2133;NA;90391;732;2021-11-13;-90589
2021-11-12;"Trenčiansky kraj";784;3884;341;4225;NA;90391;1125;2021-11-12;-91321
2021-11-11;"Trenčiansky kraj";805;3594;347;3941;NA;90391;1152;2021-11-11;-92446
2021-11-10;"Trenčiansky kraj";647;3389;282;3671;NA;90391;929;2021-11-10;-93598
2021-11-09;"Trenčiansky kraj";752;2915;306;3221;NA;90391;1058;2021-11-09;-94527
2021-11-08;"Trenčiansky kraj";489;4724;355;5079;NA;90391;844;2021-11-08;-95585
2021-11-07;"Trenčiansky kraj";405;2043;220;2263;NA;90391;625;2021-11-07;-96429
2021-11-06;"Trenčiansky kraj";542;1755;176;1931;NA;90391;718;2021-11-06;-97054
2021-11-05;"Trenčiansky kraj";677;3108;240;3348;NA;90391;917;2021-11-05;-97772
2021-11-04;"Trenčiansky kraj";563;2741;232;2973;NA;90391;795;2021-11-04;-98689
2021-11-03;"Trenčiansky kraj";619;2981;225;3206;NA;90391;844;2021-11-03;-99484
2021-11-02;"Trenčiansky kraj";663;3884;313;4197;NA;90391;976;2021-11-02;-100328
2021-11-01;"Trenčiansky kraj";219;1029;101;1130;NA;90391;320;2021-11-01;-101304
2021-10-31;"Trenčiansky kraj";151;1462;152;1614;NA;90391;303;2021-10-31;-101624
2021-10-30;"Trenčiansky kraj";345;1770;130;1900;NA;90391;475;2021-10-30;-101927
2021-10-29;"Trenčiansky kraj";415;2885;130;3015;NA;90391;545;2021-10-29;-102402
2021-10-28;"Trenčiansky kraj";429;2682;159;2841;NA;90391;588;2021-10-28;-102947
2021-10-27;"Trenčiansky kraj";463;2640;94;2734;NA;90391;557;2021-10-27;-103535
2021-10-26;"Trenčiansky kraj";419;2657;135;2792;NA;90391;554;2021-10-26;-104092
2021-10-25;"Trenčiansky kraj";192;3431;134;3565;NA;90391;326;2021-10-25;-104646
2021-10-24;"Trenčiansky kraj";121;1643;79;1722;NA;90391;200;2021-10-24;-104972
2021-10-23;"Trenčiansky kraj";326;1737;64;1801;NA;90391;390;2021-10-23;-105172
2021-10-22;"Trenčiansky kraj";358;2722;80;2802;NA;90391;438;2021-10-22;-105562
2021-10-21;"Trenčiansky kraj";247;2369;76;2445;NA;90391;323;2021-10-21;-106000
2021-10-20;"Trenčiansky kraj";302;2124;71;2195;NA;90391;373;2021-10-20;-106323
2021-10-19;"Trenčiansky kraj";227;2866;61;2927;NA;90391;288;2021-10-19;-106696
2021-10-18;"Trenčiansky kraj";143;2522;73;2595;NA;90391;216;2021-10-18;-106984
2021-10-17;"Trenčiansky kraj";46;1457;31;1488;NA;90391;77;2021-10-17;-107200
2021-10-16;"Trenčiansky kraj";76;1671;35;1706;NA;90391;111;2021-10-16;-107277
2021-10-15;"Trenčiansky kraj";126;2970;52;3022;NA;90391;178;2021-10-15;-107388
2021-10-14;"Trenčiansky kraj";103;1717;27;1744;NA;90391;130;2021-10-14;-107566
2021-10-13;"Trenčiansky kraj";171;2672;28;2700;NA;90391;199;2021-10-13;-107696
2021-10-12;"Trenčiansky kraj";114;2364;33;2397;NA;90391;147;2021-10-12;-107895
2021-10-11;"Trenčiansky kraj";109;2571;50;2621;NA;90391;159;2021-10-11;-108042
2021-10-10;"Trenčiansky kraj";17;1487;23;1510;NA;90391;40;2021-10-10;-108201
2021-10-09;"Trenčiansky kraj";157;1809;16;1825;NA;90391;173;2021-10-09;-108241
2021-10-08;"Trenčiansky kraj";82;3100;38;3138;NA;90391;120;2021-10-08;-108414
2021-10-07;"Trenčiansky kraj";107;2054;32;2086;NA;90391;139;2021-10-07;-108534
2021-10-06;"Trenčiansky kraj";193;2300;37;2337;NA;90391;230;2021-10-06;-108673
2021-10-05;"Trenčiansky kraj";119;2236;42;2278;NA;90391;161;2021-10-05;-108903
2021-10-04;"Trenčiansky kraj";105;2775;53;2828;NA;90391;158;2021-10-04;-109064
2021-10-03;"Trenčiansky kraj";30;1558;27;1585;NA;90391;57;2021-10-03;-109222
2021-10-02;"Trenčiansky kraj";107;1794;35;1829;NA;90391;142;2021-10-02;-109279
2021-10-01;"Trenčiansky kraj";119;2692;37;2729;NA;90391;156;2021-10-01;-109421
2021-09-30;"Trenčiansky kraj";74;2329;50;2379;NA;90391;124;2021-09-30;-109577
2021-09-29;"Trenčiansky kraj";170;2151;30;2181;NA;90391;200;2021-09-29;-109701
2021-09-28;"Trenčiansky kraj";95;2270;31;2301;NA;90391;126;2021-09-28;-109901
2021-09-27;"Trenčiansky kraj";56;2819;57;2876;NA;90391;113;2021-09-27;-110027
2021-09-26;"Trenčiansky kraj";20;1675;33;1708;NA;90391;53;2021-09-26;-110140
2021-09-25;"Trenčiansky kraj";76;1674;21;1695;NA;90391;97;2021-09-25;-110193
2021-09-24;"Trenčiansky kraj";104;3222;35;3257;NA;90391;139;2021-09-24;-110290
2021-09-23;"Trenčiansky kraj";91;2252;27;2279;NA;90391;118;2021-09-23;-110429
2021-09-22;"Trenčiansky kraj";90;2147;24;2171;NA;90391;114;2021-09-22;-110547
2021-09-21;"Trenčiansky kraj";79;2309;29;2338;NA;90391;108;2021-09-21;-110661
2021-09-20;"Trenčiansky kraj";78;2615;37;2652;NA;90391;115;2021-09-20;-110769
2021-09-19;"Trenčiansky kraj";11;1571;20;1591;NA;90391;31;2021-09-19;-110884
2021-09-18;"Trenčiansky kraj";53;2099;14;2113;NA;90391;67;2021-09-18;-110915
2021-09-17;"Trenčiansky kraj";55;3144;26;3170;NA;90391;81;2021-09-17;-110982
2021-09-16;"Trenčiansky kraj";52;2164;20;2184;NA;90391;72;2021-09-16;-111063
2021-09-15;"Trenčiansky kraj";63;1043;7;1050;NA;90391;70;2021-09-15;-111135
2021-09-14;"Trenčiansky kraj";67;2450;25;2475;NA;90391;92;2021-09-14;-111205
2021-09-13;"Trenčiansky kraj";33;2276;35;2311;NA;90391;68;2021-09-13;-111297
2021-09-12;"Trenčiansky kraj";3;1411;11;1422;NA;90391;14;2021-09-12;-111365
2021-09-11;"Trenčiansky kraj";55;1729;6;1735;NA;90391;61;2021-09-11;-111379
2021-09-10;"Trenčiansky kraj";49;2248;15;2263;NA;90391;64;2021-09-10;-111440
2021-09-09;"Trenčiansky kraj";24;1685;30;1715;NA;90391;54;2021-09-09;-111504
2021-09-08;"Trenčiansky kraj";54;1773;15;1788;NA;90391;69;2021-09-08;-111558
2021-09-07;"Trenčiansky kraj";43;1395;18;1413;NA;90391;61;2021-09-07;-111627
2021-09-06;"Trenčiansky kraj";47;1401;15;1416;NA;90391;62;2021-09-06;-111688
2021-09-05;"Trenčiansky kraj";2;966;23;989;NA;90391;25;2021-09-05;-111750
2021-09-04;"Trenčiansky kraj";41;925;4;929;NA;90391;45;2021-09-04;-111775
2021-09-03;"Trenčiansky kraj";53;1422;15;1437;NA;90391;68;2021-09-03;-111820
2021-09-02;"Trenčiansky kraj";7;1001;14;1015;NA;90391;21;2021-09-02;-111888
2021-09-01;"Trenčiansky kraj";27;431;8;439;NA;90391;35;2021-09-01;-111909
2021-08-31;"Trenčiansky kraj";21;1146;15;1161;NA;90391;36;2021-08-31;-111944
2021-08-30;"Trenčiansky kraj";32;1168;10;1178;NA;90391;42;2021-08-30;-111980
2021-08-29;"Trenčiansky kraj";1;482;11;493;NA;90391;12;2021-08-29;-112022
2021-08-28;"Trenčiansky kraj";9;976;10;986;NA;90391;19;2021-08-28;-112034
2021-08-27;"Trenčiansky kraj";21;1599;1;1600;NA;90391;22;2021-08-27;-112053
2021-08-26;"Trenčiansky kraj";8;993;6;999;NA;90391;14;2021-08-26;-112075
2021-08-25;"Trenčiansky kraj";40;875;7;882;NA;90391;47;2021-08-25;-112089
2021-08-24;"Trenčiansky kraj";4;822;4;826;NA;90391;8;2021-08-24;-112136
2021-08-23;"Trenčiansky kraj";6;1165;17;1182;NA;90391;23;2021-08-23;-112144
2021-08-22;"Trenčiansky kraj";0;726;10;736;NA;90391;10;2021-08-22;-112167
2021-08-21;"Trenčiansky kraj";5;964;7;971;NA;90391;12;2021-08-21;-112177
2021-08-20;"Trenčiansky kraj";15;1538;2;1540;NA;90391;17;2021-08-20;-112189
2021-08-19;"Trenčiansky kraj";2;986;2;988;NA;90391;4;2021-08-19;-112206
2021-08-18;"Trenčiansky kraj";6;816;7;823;NA;90391;13;2021-08-18;-112210
2021-08-17;"Trenčiansky kraj";9;634;1;635;NA;90391;10;2021-08-17;-112223
2021-08-16;"Trenčiansky kraj";5;929;3;932;NA;90391;8;2021-08-16;-112233
2021-08-15;"Trenčiansky kraj";0;558;1;559;NA;90391;1;2021-08-15;-112241
2021-08-14;"Trenčiansky kraj";12;574;6;580;NA;90391;18;2021-08-14;-112242
2021-08-13;"Trenčiansky kraj";2;934;0;934;NA;90391;2;2021-08-13;-112260
2021-08-12;"Trenčiansky kraj";2;566;3;569;NA;90391;5;2021-08-12;-112262
2021-08-11;"Trenčiansky kraj";1;683;0;683;NA;90391;1;2021-08-11;-112267
2021-08-10;"Trenčiansky kraj";8;532;1;533;NA;90391;9;2021-08-10;-112268
2021-08-09;"Trenčiansky kraj";8;698;1;699;NA;90391;9;2021-08-09;-112277
2021-08-08;"Trenčiansky kraj";0;468;0;468;NA;90391;0;2021-08-08;-112286
2021-08-07;"Trenčiansky kraj";3;464;0;464;NA;90391;3;2021-08-07;-112286
2021-08-06;"Trenčiansky kraj";3;956;1;957;NA;90391;4;2021-08-06;-112289
2021-08-05;"Trenčiansky kraj";3;582;1;583;NA;90391;4;2021-08-05;-112293
2021-08-04;"Trenčiansky kraj";14;549;3;552;NA;90391;17;2021-08-04;-112297
2021-08-03;"Trenčiansky kraj";9;510;5;515;NA;90391;14;2021-08-03;-112314
2021-08-02;"Trenčiansky kraj";1;811;2;813;NA;90391;3;2021-08-02;-112328
2021-08-01;"Trenčiansky kraj";0;514;1;515;NA;90391;1;2021-08-01;-112331
2021-07-31;"Trenčiansky kraj";4;525;2;527;NA;90391;6;2021-07-31;-112332
2021-07-30;"Trenčiansky kraj";2;1071;0;1071;NA;90391;2;2021-07-30;-112338
2021-07-29;"Trenčiansky kraj";5;710;0;710;NA;90391;5;2021-07-29;-112340
2021-07-28;"Trenčiansky kraj";3;521;2;523;NA;90391;5;2021-07-28;-112345
2021-07-27;"Trenčiansky kraj";6;553;1;554;NA;90391;7;2021-07-27;-112350
2021-07-26;"Trenčiansky kraj";7;781;1;782;NA;90391;8;2021-07-26;-112357
2021-07-25;"Trenčiansky kraj";0;487;2;489;NA;90391;2;2021-07-25;-112365
2021-07-24;"Trenčiansky kraj";3;643;1;644;NA;90391;4;2021-07-24;-112367
2021-07-23;"Trenčiansky kraj";3;1154;0;1154;NA;90391;3;2021-07-23;-112371
2021-07-22;"Trenčiansky kraj";2;849;2;851;NA;90391;4;2021-07-22;-112374
2021-07-21;"Trenčiansky kraj";8;667;2;669;NA;90391;10;2021-07-21;-112378
2021-07-20;"Trenčiansky kraj";4;530;1;531;NA;90391;5;2021-07-20;-112388
2021-07-19;"Trenčiansky kraj";0;878;4;882;NA;90391;4;2021-07-19;-112393
2021-07-18;"Trenčiansky kraj";0;526;0;526;NA;90391;0;2021-07-18;-112397
2021-07-17;"Trenčiansky kraj";3;673;0;673;NA;90391;3;2021-07-17;-112397
2021-07-16;"Trenčiansky kraj";4;1126;0;1126;NA;90391;4;2021-07-16;-112400
2021-07-15;"Trenčiansky kraj";2;830;0;830;NA;90391;2;2021-07-15;-112404
2021-07-14;"Trenčiansky kraj";8;665;1;666;NA;90391;9;2021-07-14;-112406
2021-07-13;"Trenčiansky kraj";1;528;3;531;NA;90391;4;2021-07-13;-112415
2021-07-12;"Trenčiansky kraj";9;827;3;830;NA;90391;12;2021-07-12;-112419
2021-07-11;"Trenčiansky kraj";0;611;2;613;NA;90391;2;2021-07-11;-112431
2021-07-10;"Trenčiansky kraj";2;535;0;535;NA;90391;2;2021-07-10;-112433
2021-07-09;"Trenčiansky kraj";7;1387;2;1389;NA;90391;9;2021-07-09;-112435
2021-07-08;"Trenčiansky kraj";2;824;1;825;NA;90391;3;2021-07-08;-112444
2021-07-07;"Trenčiansky kraj";2;943;1;944;NA;90391;3;2021-07-07;-112447
2021-07-06;"Trenčiansky kraj";4;1046;2;1048;NA;90391;6;2021-07-06;-112450
2021-07-05;"Trenčiansky kraj";1;516;0;516;NA;90391;1;2021-07-05;-112456
2021-07-04;"Trenčiansky kraj";0;612;1;613;NA;90391;1;2021-07-04;-112457
2021-07-03;"Trenčiansky kraj";3;815;1;816;NA;90391;4;2021-07-03;-112458
2021-07-02;"Trenčiansky kraj";5;1590;2;1592;NA;90391;7;2021-07-02;-112462
2021-07-01;"Trenčiansky kraj";4;1173;1;1174;NA;90391;5;2021-07-01;-112469
2021-06-30;"Trenčiansky kraj";2;7021;6;7027;NA;90391;8;2021-06-30;-112474
2021-06-29;"Trenčiansky kraj";4;2773;5;2778;NA;90391;9;2021-06-29;-112482
2021-06-28;"Trenčiansky kraj";5;3672;9;3681;NA;90391;14;2021-06-28;-112491
2021-06-27;"Trenčiansky kraj";0;2861;1;2862;NA;90391;1;2021-06-27;-112505
2021-06-26;"Trenčiansky kraj";1;3547;4;3551;NA;90391;5;2021-06-26;-112506
2021-06-25;"Trenčiansky kraj";2;4635;2;4637;NA;90391;4;2021-06-25;-112511
2021-06-24;"Trenčiansky kraj";3;3320;4;3324;NA;90391;7;2021-06-24;-112515
2021-06-23;"Trenčiansky kraj";4;2808;2;2810;NA;90391;6;2021-06-23;-112522
2021-06-22;"Trenčiansky kraj";7;3137;4;3141;NA;90391;11;2021-06-22;-112528
2021-06-21;"Trenčiansky kraj";10;3891;4;3895;NA;90391;14;2021-06-21;-112539
2021-06-20;"Trenčiansky kraj";0;3579;5;3584;NA;90391;5;2021-06-20;-112553
2021-06-19;"Trenčiansky kraj";5;4528;1;4529;NA;90391;6;2021-06-19;-112558
2021-06-18;"Trenčiansky kraj";7;6725;7;6732;NA;90391;14;2021-06-18;-112564
2021-06-17;"Trenčiansky kraj";0;3469;6;3475;NA;90391;6;2021-06-17;-112578
2021-06-16;"Trenčiansky kraj";4;3183;3;3186;NA;90391;7;2021-06-16;-112584
2021-06-15;"Trenčiansky kraj";10;3697;2;3699;NA;90391;12;2021-06-15;-112591
2021-06-14;"Trenčiansky kraj";10;4805;15;4820;NA;90391;25;2021-06-14;-112603
2021-06-13;"Trenčiansky kraj";0;4643;4;4647;NA;90391;4;2021-06-13;-112628
2021-06-12;"Trenčiansky kraj";4;5260;8;5268;NA;90391;12;2021-06-12;-112632
2021-06-11;"Trenčiansky kraj";10;7365;11;7376;NA;90391;21;2021-06-11;-112644
2021-06-10;"Trenčiansky kraj";5;4345;7;4352;NA;90391;12;2021-06-10;-112665
2021-06-09;"Trenčiansky kraj";7;3693;7;3700;NA;90391;14;2021-06-09;-112677
2021-06-08;"Trenčiansky kraj";21;3965;7;3972;NA;90391;28;2021-06-08;-112691
2021-06-07;"Trenčiansky kraj";13;5560;10;5570;NA;90391;23;2021-06-07;-112719
2021-06-06;"Trenčiansky kraj";0;5500;10;5510;NA;90391;10;2021-06-06;-112742
2021-06-05;"Trenčiansky kraj";7;6511;5;6516;NA;90391;12;2021-06-05;-112752
2021-06-04;"Trenčiansky kraj";16;7653;3;7656;NA;90391;19;2021-06-04;-112764
2021-06-03;"Trenčiansky kraj";9;4485;10;4495;NA;90391;19;2021-06-03;-112783
2021-06-02;"Trenčiansky kraj";28;4329;8;4337;NA;90391;36;2021-06-02;-112802
2021-06-01;"Trenčiansky kraj";22;5396;18;5414;NA;90391;40;2021-06-01;-112838
2021-05-31;"Trenčiansky kraj";30;6117;24;6141;NA;90391;54;2021-05-31;-112878
2021-05-30;"Trenčiansky kraj";0;8258;16;8274;NA;90391;16;2021-05-30;-112932
2021-05-29;"Trenčiansky kraj";13;7915;14;7929;NA;90391;27;2021-05-29;-112948
2021-05-28;"Trenčiansky kraj";22;8995;25;9020;NA;90391;47;2021-05-28;-112975
2021-05-27;"Trenčiansky kraj";6;5205;12;5217;NA;90391;18;2021-05-27;-113022
2021-05-26;"Trenčiansky kraj";26;5069;15;5084;NA;90391;41;2021-05-26;-113040
2021-05-25;"Trenčiansky kraj";18;6168;24;6192;NA;90391;42;2021-05-25;-113081
2021-05-24;"Trenčiansky kraj";19;9292;37;9329;NA;90391;56;2021-05-24;-113123
2021-05-23;"Trenčiansky kraj";0;9083;26;9109;NA;90391;26;2021-05-23;-113179
2021-05-22;"Trenčiansky kraj";11;11314;21;11335;NA;90391;32;2021-05-22;-113205
2021-05-21;"Trenčiansky kraj";23;11572;26;11598;NA;90391;49;2021-05-21;-113237
2021-05-20;"Trenčiansky kraj";23;6320;25;6345;NA;90391;48;2021-05-20;-113286
2021-05-19;"Trenčiansky kraj";16;5694;32;5726;NA;90391;48;2021-05-19;-113334
2021-05-18;"Trenčiansky kraj";26;7779;28;7807;NA;90391;54;2021-05-18;-113382
2021-05-17;"Trenčiansky kraj";37;7671;43;7714;NA;90391;80;2021-05-17;-113436
2021-05-16;"Trenčiansky kraj";25;15615;41;15656;NA;90391;66;2021-05-16;-113516
2021-05-15;"Trenčiansky kraj";3;21237;32;21269;NA;90391;35;2021-05-15;-113582
2021-05-14;"Trenčiansky kraj";41;18676;42;18718;NA;90391;83;2021-05-14;-113617
2021-05-13;"Trenčiansky kraj";41;8195;24;8219;NA;90391;65;2021-05-13;-113700
2021-05-12;"Trenčiansky kraj";41;7409;31;7440;NA;90391;72;2021-05-12;-113765
2021-05-11;"Trenčiansky kraj";66;10507;32;10539;NA;90391;98;2021-05-11;-113837
2021-05-10;"Trenčiansky kraj";48;12989;55;13044;NA;90391;103;2021-05-10;-113935
2021-05-09;"Trenčiansky kraj";52;17737;39;17776;NA;90391;91;2021-05-09;-114038
2021-05-08;"Trenčiansky kraj";3;23822;33;23855;NA;90391;36;2021-05-08;-114129
2021-05-07;"Trenčiansky kraj";45;23549;56;23605;NA;90391;101;2021-05-07;-114165
2021-05-06;"Trenčiansky kraj";26;10771;44;10815;NA;90391;70;2021-05-06;-114266
2021-05-05;"Trenčiansky kraj";73;9377;41;9418;NA;90391;114;2021-05-05;-114336
2021-05-04;"Trenčiansky kraj";55;12733;53;12786;NA;90391;108;2021-05-04;-114450
2021-05-03;"Trenčiansky kraj";60;15331;51;15382;NA;90391;111;2021-05-03;-114558
2021-05-02;"Trenčiansky kraj";0;31152;65;31217;NA;90391;65;2021-05-02;-114669
2021-05-01;"Trenčiansky kraj";71;56982;60;57042;NA;90391;131;2021-05-01;-114734
2021-04-30;"Trenčiansky kraj";77;29427;61;29488;NA;90391;138;2021-04-30;-114865
2021-04-29;"Trenčiansky kraj";49;13184;59;13243;NA;90391;108;2021-04-29;-115003
2021-04-28;"Trenčiansky kraj";79;12537;52;12589;NA;90391;131;2021-04-28;-115111
2021-04-27;"Trenčiansky kraj";107;15527;40;15567;NA;90391;147;2021-04-27;-115242
2021-04-26;"Trenčiansky kraj";52;21070;63;21133;NA;90391;115;2021-04-26;-115389
2021-04-25;"Trenčiansky kraj";0;34560;48;34608;NA;90391;48;2021-04-25;-115504
2021-04-24;"Trenčiansky kraj";76;72398;100;72498;NA;90391;176;2021-04-24;-115552
2021-04-23;"Trenčiansky kraj";143;29959;79;30038;NA;90391;222;2021-04-23;-115728
2021-04-22;"Trenčiansky kraj";71;13847;64;13911;NA;90391;135;2021-04-22;-115950
2021-04-21;"Trenčiansky kraj";79;13000;67;13067;NA;90391;146;2021-04-21;-116085
2021-04-20;"Trenčiansky kraj";142;17740;80;17820;NA;90391;222;2021-04-20;-116231
2021-04-19;"Trenčiansky kraj";102;22631;103;22734;NA;90391;205;2021-04-19;-116453
2021-04-18;"Trenčiansky kraj";3;40879;97;40976;NA;90391;100;2021-04-18;-116658
2021-04-17;"Trenčiansky kraj";77;81498;136;81634;NA;90391;213;2021-04-17;-116758
2021-04-16;"Trenčiansky kraj";100;31961;90;32051;NA;90391;190;2021-04-16;-116971
2021-04-15;"Trenčiansky kraj";71;14479;69;14548;NA;90391;140;2021-04-15;-117161
2021-04-14;"Trenčiansky kraj";135;15563;72;15635;NA;90391;207;2021-04-14;-117301
2021-04-13;"Trenčiansky kraj";189;18721;75;18796;NA;90391;264;2021-04-13;-117508
2021-04-12;"Trenčiansky kraj";97;23743;91;23834;NA;90391;188;2021-04-12;-117772
2021-04-11;"Trenčiansky kraj";1;34735;75;34810;NA;90391;76;2021-04-11;-117960
2021-04-10;"Trenčiansky kraj";81;83093;145;83238;NA;90391;226;2021-04-10;-118036
2021-04-09;"Trenčiansky kraj";120;28014;91;28105;NA;90391;211;2021-04-09;-118262
2021-04-08;"Trenčiansky kraj";112;13283;85;13368;NA;90391;197;2021-04-08;-118473
2021-04-07;"Trenčiansky kraj";204;17688;123;17811;NA;90391;327;2021-04-07;-118670
2021-04-06;"Trenčiansky kraj";157;28567;178;28745;NA;90391;335;2021-04-06;-118997
2021-04-05;"Trenčiansky kraj";15;9227;64;9291;NA;90391;79;2021-04-05;-119332
2021-04-04;"Trenčiansky kraj";2;20291;85;20376;NA;90391;87;2021-04-04;-119411
2021-04-03;"Trenčiansky kraj";86;80473;221;80694;NA;90391;307;2021-04-03;-119498
2021-04-02;"Trenčiansky kraj";126;21620;81;21701;NA;90391;207;2021-04-02;-119805
2021-04-01;"Trenčiansky kraj";159;32376;139;32515;NA;90391;298;2021-04-01;-120012
2021-03-31;"Trenčiansky kraj";198;20100;130;20230;NA;90391;328;2021-03-31;-120310
2021-03-30;"Trenčiansky kraj";272;17305;136;17441;NA;90391;408;2021-03-30;-120638
2021-03-29;"Trenčiansky kraj";142;19479;170;19649;NA;90391;312;2021-03-29;-121046
2021-03-28;"Trenčiansky kraj";3;34759;116;34875;NA;90391;119;2021-03-28;-121358
2021-03-27;"Trenčiansky kraj";130;77314;293;77607;NA;90391;423;2021-03-27;-121477
2021-03-26;"Trenčiansky kraj";211;35095;157;35252;NA;90391;368;2021-03-26;-121900
2021-03-25;"Trenčiansky kraj";184;16580;176;16756;NA;90391;360;2021-03-25;-122268
2021-03-24;"Trenčiansky kraj";259;13102;171;13273;NA;90391;430;2021-03-24;-122628
2021-03-23;"Trenčiansky kraj";349;17589;174;17763;NA;90391;523;2021-03-23;-123058
2021-03-22;"Trenčiansky kraj";141;21116;213;21329;NA;90391;354;2021-03-22;-123581
2021-03-21;"Trenčiansky kraj";85;32711;164;32875;NA;90391;249;2021-03-21;-123935
2021-03-20;"Trenčiansky kraj";128;80035;322;80357;NA;90391;450;2021-03-20;-124184
2021-03-19;"Trenčiansky kraj";231;34783;232;35015;NA;90391;463;2021-03-19;-124634
2021-03-18;"Trenčiansky kraj";262;16105;178;16283;NA;90391;440;2021-03-18;-125097
2021-03-17;"Trenčiansky kraj";366;13435;164;13599;NA;90391;530;2021-03-17;-125537
2021-03-16;"Trenčiansky kraj";450;15282;241;15523;NA;90391;691;2021-03-16;-126067
2021-03-15;"Trenčiansky kraj";162;21235;261;21496;NA;90391;423;2021-03-15;-126758
2021-03-14;"Trenčiansky kraj";42;34416;238;34654;NA;90391;280;2021-03-14;-127181
2021-03-13;"Trenčiansky kraj";270;79186;453;79639;NA;90391;723;2021-03-13;-127461
2021-03-12;"Trenčiansky kraj";366;34795;307;35102;NA;90391;673;2021-03-12;-128184
2021-03-11;"Trenčiansky kraj";302;15558;213;15771;NA;90391;515;2021-03-11;-128857
2021-03-10;"Trenčiansky kraj";402;13585;237;13822;NA;90391;639;2021-03-10;-129372
2021-03-09;"Trenčiansky kraj";586;17982;285;18267;NA;90391;871;2021-03-09;-130011
2021-03-08;"Trenčiansky kraj";174;21704;363;22067;NA;90391;537;2021-03-08;-130882
2021-03-07;"Trenčiansky kraj";4;33660;313;33973;NA;90391;317;2021-03-07;-131419
2021-03-06;"Trenčiansky kraj";260;79661;529;80190;NA;90391;789;2021-03-06;-131736
2021-03-05;"Trenčiansky kraj";326;32969;415;33384;NA;90391;741;2021-03-05;-132525
2021-03-04;"Trenčiansky kraj";323;16821;317;17138;NA;90391;640;2021-03-04;-133266
2021-03-03;"Trenčiansky kraj";413;13960;347;14307;NA;90391;760;2021-03-03;-133906
2021-03-02;"Trenčiansky kraj";612;17794;344;18138;NA;90391;956;2021-03-02;-134666
2021-03-01;"Trenčiansky kraj";217;21104;445;21549;NA;90391;662;2021-03-01;-135622
2021-02-28;"Trenčiansky kraj";45;30238;376;30614;NA;90391;421;2021-02-28;-136284
2021-02-27;"Trenčiansky kraj";277;78735;686;79421;NA;90391;963;2021-02-27;-136705
2021-02-26;"Trenčiansky kraj";420;32940;434;33374;NA;90391;854;2021-02-26;-137668
2021-02-25;"Trenčiansky kraj";424;14029;328;14357;NA;90391;752;2021-02-25;-138522
2021-02-24;"Trenčiansky kraj";427;12014;399;12413;NA;90391;826;2021-02-24;-139274
2021-02-23;"Trenčiansky kraj";577;14904;390;15294;NA;90391;967;2021-02-23;-140100
2021-02-22;"Trenčiansky kraj";160;19969;468;20437;NA;90391;628;2021-02-22;-141067
2021-02-21;"Trenčiansky kraj";64;29478;392;29870;NA;90391;456;2021-02-21;-141695
2021-02-20;"Trenčiansky kraj";274;77840;745;78585;NA;90391;1019;2021-02-20;-142151
2021-02-19;"Trenčiansky kraj";272;30260;523;30783;NA;90391;795;2021-02-19;-143170
2021-02-18;"Trenčiansky kraj";355;14094;403;14497;NA;90391;758;2021-02-18;-143965
2021-02-17;"Trenčiansky kraj";363;11412;376;11788;NA;90391;739;2021-02-17;-144723
2021-02-16;"Trenčiansky kraj";488;17761;406;18167;NA;90391;894;2021-02-16;-145462
2021-02-15;"Trenčiansky kraj";151;21846;463;22309;NA;90391;614;2021-02-15;-146356
2021-02-14;"Trenčiansky kraj";2;31255;324;31579;NA;90391;326;2021-02-14;-146970
2021-02-13;"Trenčiansky kraj";274;63006;522;63528;NA;90391;796;2021-02-13;-147296
2021-02-12;"Trenčiansky kraj";276;27979;412;28391;NA;90391;688;2021-02-12;-148092
2021-02-11;"Trenčiansky kraj";291;11567;323;11890;NA;90391;614;2021-02-11;-148780
2021-02-10;"Trenčiansky kraj";304;11408;317;11725;NA;90391;621;2021-02-10;-149394
2021-02-09;"Trenčiansky kraj";514;18412;360;18772;NA;90391;874;2021-02-09;-150015
2021-02-08;"Trenčiansky kraj";182;26832;430;27262;NA;90391;612;2021-02-08;-150889
2021-02-07;"Trenčiansky kraj";31;36781;341;37122;NA;90391;372;2021-02-07;-151501
2021-02-06;"Trenčiansky kraj";216;63931;560;64491;NA;90391;776;2021-02-06;-151873
2021-02-05;"Trenčiansky kraj";202;18164;367;18531;NA;90391;569;2021-02-05;-152649
2021-02-04;"Trenčiansky kraj";266;7253;311;7564;NA;90391;577;2021-02-04;-153218
2021-02-03;"Trenčiansky kraj";162;6723;320;7043;NA;90391;482;2021-02-03;-153795
2021-02-02;"Trenčiansky kraj";347;8074;381;8455;NA;90391;728;2021-02-02;-154277
2021-02-01;"Trenčiansky kraj";167;8921;311;9232;NA;90391;478;2021-02-01;-155005
2021-01-31;"Trenčiansky kraj";7;19103;159;19262;NA;90391;166;2021-01-31;-155483
2021-01-30;"Trenčiansky kraj";228;38167;332;38499;NA;90391;560;2021-01-30;-155649
2021-01-29;"Trenčiansky kraj";214;7590;235;7825;NA;90391;449;2021-01-29;-156209
2021-01-28;"Trenčiansky kraj";307;5442;158;5600;NA;90391;465;2021-01-28;-156658
2021-01-27;"Trenčiansky kraj";166;4842;181;5023;NA;90391;347;2021-01-27;-157123
2021-01-26;"Trenčiansky kraj";303;14589;250;14839;NA;90391;553;2021-01-26;-157470
2021-01-25;"Trenčiansky kraj";160;24310;207;24517;NA;90391;367;2021-01-25;-158023
2021-01-24;"Trenčiansky kraj";51;38369;282;38651;NA;90391;333;2021-01-24;-158390
2021-01-23;"Trenčiansky kraj";206;114125;749;114874;NA;90391;955;2021-01-23;-158723
2021-01-22;"Trenčiansky kraj";148;21831;241;22072;NA;90391;389;2021-01-22;-159678
2021-01-21;"Trenčiansky kraj";143;8586;166;8752;NA;90391;309;2021-01-21;-160067
2021-01-20;"Trenčiansky kraj";181;8189;227;8416;NA;90391;408;2021-01-20;-160376
2021-01-19;"Trenčiansky kraj";363;6600;262;6862;NA;90391;625;2021-01-19;-160784
2021-01-18;"Trenčiansky kraj";72;4970;321;5291;NA;90391;393;2021-01-18;-161409
2021-01-17;"Trenčiansky kraj";124;156;11;167;NA;90391;135;2021-01-17;-161802
2021-01-16;"Trenčiansky kraj";39;1288;53;1341;NA;90391;92;2021-01-16;-161937
2021-01-15;"Trenčiansky kraj";264;4031;214;4245;NA;90391;478;2021-01-15;-162029
2021-01-14;"Trenčiansky kraj";275;3193;189;3382;NA;90391;464;2021-01-14;-162507
2021-01-13;"Trenčiansky kraj";222;3893;215;4108;NA;90391;437;2021-01-13;-162971
2021-01-12;"Trenčiansky kraj";508;4604;261;4865;NA;90391;769;2021-01-12;-163408
2021-01-11;"Trenčiansky kraj";142;4367;354;4721;NA;90391;496;2021-01-11;-164177
2021-01-10;"Trenčiansky kraj";89;4969;77;5046;NA;90391;166;2021-01-10;-164673
2021-01-09;"Trenčiansky kraj";276;8280;128;8408;NA;90391;404;2021-01-09;-164839
2021-01-08;"Trenčiansky kraj";489;6435;484;6919;NA;90391;973;2021-01-08;-165243
2021-01-07;"Trenčiansky kraj";420;6138;577;6715;NA;90391;997;2021-01-07;-166216
2021-01-06;"Trenčiansky kraj";221;1021;64;1085;NA;90391;285;2021-01-06;-167213
2021-01-05;"Trenčiansky kraj";669;5753;706;6459;NA;90391;1375;2021-01-05;-167498
2021-01-04;"Trenčiansky kraj";337;5248;782;6030;NA;90391;1119;2021-01-04;-168873
2021-01-03;"Trenčiansky kraj";38;114;15;129;NA;90391;53;2021-01-03;-169992
2021-01-02;"Trenčiansky kraj";129;196;23;219;NA;90391;152;2021-01-02;-170045
2021-01-01;"Trenčiansky kraj";329;347;23;370;NA;90391;352;2021-01-01;-170197
2020-12-31;"Trenčiansky kraj";597;4943;557;5500;NA;90391;1154;2020-12-31;-170549
2020-12-30;"Trenčiansky kraj";836;7012;762;7774;NA;90391;1598;2020-12-30;-171703
2020-12-29;"Trenčiansky kraj";459;6121;1009;7130;NA;90391;1468;2020-12-29;-173301
2020-12-28;"Trenčiansky kraj";258;4195;777;4972;NA;90391;1035;2020-12-28;-174769
2020-12-27;"Trenčiansky kraj";5;208;36;244;NA;90391;41;2020-12-27;-175804
2020-12-26;"Trenčiansky kraj";174;74;10;84;NA;90391;184;2020-12-26;-175845
2020-12-25;"Trenčiansky kraj";251;325;47;372;NA;90391;298;2020-12-25;-176029
2020-12-24;"Trenčiansky kraj";552;2194;256;2450;NA;90391;808;2020-12-24;-176327
2020-12-23;"Trenčiansky kraj";421;6552;661;7213;NA;90391;1082;2020-12-23;-177135
2020-12-22;"Trenčiansky kraj";673;5760;694;6454;NA;90391;1367;2020-12-22;-178217
2020-12-21;"Trenčiansky kraj";248;13395;979;14374;NA;90391;1227;2020-12-21;-179584
2020-12-20;"Trenčiansky kraj";238;12504;292;12796;NA;90391;530;2020-12-20;-180811
2020-12-19;"Trenčiansky kraj";341;1611;150;1761;NA;90391;491;2020-12-19;-181341
2020-12-18;"Trenčiansky kraj";521;5199;615;5814;NA;90391;1136;2020-12-18;-181832
2020-12-17;"Trenčiansky kraj";670;3843;524;4367;NA;90391;1194;2020-12-17;-182968
2020-12-16;"Trenčiansky kraj";461;4474;648;5122;NA;90391;1109;2020-12-16;-184162
2020-12-15;"Trenčiansky kraj";595;3805;670;4475;NA;90391;1265;2020-12-15;-185271
2020-12-14;"Trenčiansky kraj";318;2907;552;3459;NA;90391;870;2020-12-14;-186536
2020-12-13;"Trenčiansky kraj";77;49;6;55;NA;90391;83;2020-12-13;-187406
2020-12-12;"Trenčiansky kraj";314;1191;136;1327;NA;90391;450;2020-12-12;-187489
2020-12-11;"Trenčiansky kraj";751;3773;453;4226;NA;90391;1204;2020-12-11;-187939
2020-12-10;"Trenčiansky kraj";271;3354;473;3827;NA;90391;744;2020-12-10;-189143
2020-12-09;"Trenčiansky kraj";508;3788;466;4254;NA;90391;974;2020-12-09;-189887
2020-12-08;"Trenčiansky kraj";546;3440;522;3962;NA;90391;1068;2020-12-08;-190861
2020-12-07;"Trenčiansky kraj";258;3832;468;4300;NA;90391;726;2020-12-07;-191929
2020-12-06;"Trenčiansky kraj";114;179;10;189;NA;90391;124;2020-12-06;-192655
2020-12-05;"Trenčiansky kraj";223;610;56;666;NA;90391;279;2020-12-05;-192779
2020-12-04;"Trenčiansky kraj";253;2943;273;3216;NA;90391;526;2020-12-04;-193058
2020-12-03;"Trenčiansky kraj";503;1714;178;1892;NA;90391;681;2020-12-03;-193584
2020-12-02;"Trenčiansky kraj";418;1844;232;2076;NA;90391;650;2020-12-02;-194265
2020-12-01;"Trenčiansky kraj";321;5642;351;5993;NA;90391;672;2020-12-01;-194915
2020-11-30;"Trenčiansky kraj";167;11514;520;12034;NA;90391;687;2020-11-30;-195587
2020-11-29;"Trenčiansky kraj";29;30;5;35;NA;90391;34;2020-11-29;-196274
2020-11-28;"Trenčiansky kraj";202;1051;93;1144;NA;90391;295;2020-11-28;-196308
2020-11-27;"Trenčiansky kraj";330;1888;186;2074;NA;90391;516;2020-11-27;-196603
2020-11-26;"Trenčiansky kraj";395;1252;122;1374;NA;90391;517;2020-11-26;-197119
2020-11-25;"Trenčiansky kraj";322;1444;160;1604;NA;90391;482;2020-11-25;-197636
2020-11-24;"Trenčiansky kraj";348;2553;308;2861;NA;90391;656;2020-11-24;-198118
2020-11-23;"Trenčiansky kraj";159;1186;122;1308;NA;90391;281;2020-11-23;-198774
2020-11-22;"Trenčiansky kraj";26;30;7;37;NA;90391;33;2020-11-22;-199055
2020-11-21;"Trenčiansky kraj";255;1376;69;1445;NA;90391;324;2020-11-21;-199088
2020-11-20;"Trenčiansky kraj";316;861;93;954;NA;90391;409;2020-11-20;-199412
2020-11-19;"Trenčiansky kraj";316;740;113;853;NA;90391;429;2020-11-19;-199821
2020-11-18;"Trenčiansky kraj";233;379;66;445;NA;90391;299;2020-11-18;-200250
2020-11-17;"Trenčiansky kraj";222;106;15;121;NA;90391;237;2020-11-17;-200549
2020-11-16;"Trenčiansky kraj";245;236;45;281;NA;90391;290;2020-11-16;-200786
2020-11-15;"Trenčiansky kraj";109;29;6;35;NA;90391;115;2020-11-15;-201076
2020-11-14;"Trenčiansky kraj";190;74;11;85;NA;90391;201;2020-11-14;-201191
2020-11-13;"Trenčiansky kraj";308;131;13;144;NA;90391;321;2020-11-13;-201392
2020-11-12;"Trenčiansky kraj";324;124;5;129;NA;90391;329;2020-11-12;-201713
2020-11-11;"Trenčiansky kraj";366;113;10;123;NA;90391;376;2020-11-11;-202042
2020-11-10;"Trenčiansky kraj";277;106;6;112;NA;90391;283;2020-11-10;-202418
2020-11-09;"Trenčiansky kraj";115;1407;48;1455;NA;90391;163;2020-11-09;-202701
2020-11-08;"Trenčiansky kraj";81;1271;8;1279;NA;90391;89;2020-11-08;-202864
2020-11-07;"Trenčiansky kraj";319;3662;59;3721;NA;90391;378;2020-11-07;-202953
2020-11-06;"Trenčiansky kraj";383;6893;84;6977;NA;90391;467;2020-11-06;-203331
2020-11-05;"Trenčiansky kraj";399;98;15;113;NA;90391;414;2020-11-05;-203798
2020-11-04;"Trenčiansky kraj";370;91;9;100;NA;90391;379;2020-11-04;-204212
2020-11-03;"Trenčiansky kraj";575;97;8;105;NA;90391;583;2020-11-03;-204591
2020-11-02;"Trenčiansky kraj";197;1833;68;1901;NA;90391;265;2020-11-02;-205174
2020-11-01;"Trenčiansky kraj";257;808;24;832;NA;90391;281;2020-11-01;-205439
2020-10-31;"Trenčiansky kraj";332;4719;82;4801;NA;90391;414;2020-10-31;-205720
2020-10-30;"Trenčiansky kraj";299;5283;102;5385;NA;90391;401;2020-10-30;-206134
2020-10-29;"Trenčiansky kraj";496;764;68;832;NA;90391;564;2020-10-29;-206535
2020-10-28;"Trenčiansky kraj";269;192;33;225;NA;90391;302;2020-10-28;-207099
2020-10-27;"Trenčiansky kraj";473;127;27;154;NA;90391;500;2020-10-27;-207401
2020-10-26;"Trenčiansky kraj";177;107;36;143;NA;90391;213;2020-10-26;-207901
2020-10-25;"Trenčiansky kraj";138;9;5;14;NA;90391;143;2020-10-25;-208114
2020-10-24;"Trenčiansky kraj";395;128;6;134;NA;90391;401;2020-10-24;-208257
2020-10-23;"Trenčiansky kraj";301;154;8;162;NA;90391;309;2020-10-23;-208658
2020-10-22;"Trenčiansky kraj";273;82;12;94;NA;90391;285;2020-10-22;-208967
2020-10-21;"Trenčiansky kraj";183;53;9;62;NA;90391;192;2020-10-21;-209252
2020-10-20;"Trenčiansky kraj";212;47;6;53;NA;90391;218;2020-10-20;-209444
2020-10-19;"Trenčiansky kraj";41;83;25;108;NA;90391;66;2020-10-19;-209662
2020-10-18;"Trenčiansky kraj";104;0;0;0;NA;90391;104;2020-10-18;-209728
2020-10-17;"Trenčiansky kraj";157;0;0;0;NA;90391;157;2020-10-17;-209832
2020-10-16;"Trenčiansky kraj";225;42;6;48;NA;90391;231;2020-10-16;-209989
2020-10-15;"Trenčiansky kraj";255;39;4;43;NA;90391;259;2020-10-15;-210220
2020-10-14;"Trenčiansky kraj";162;42;7;49;NA;90391;169;2020-10-14;-210479
2020-10-13;"Trenčiansky kraj";124;105;12;117;NA;90391;136;2020-10-13;-210648
2020-10-12;"Trenčiansky kraj";55;0;0;0;NA;90391;55;2020-10-12;-210784
2020-10-11;"Trenčiansky kraj";73;0;0;0;NA;90391;73;2020-10-11;-210839
2020-10-10;"Trenčiansky kraj";180;0;0;0;NA;90391;180;2020-10-10;-210912
2020-10-09;"Trenčiansky kraj";198;0;0;0;NA;90391;198;2020-10-09;-211092
2020-10-08;"Trenčiansky kraj";115;0;0;0;NA;90391;115;2020-10-08;-211290
2020-10-07;"Trenčiansky kraj";75;0;0;0;NA;90391;75;2020-10-07;-211405
2020-10-06;"Trenčiansky kraj";72;0;0;0;NA;90391;72;2020-10-06;-211480
2020-10-05;"Trenčiansky kraj";32;0;0;0;NA;90391;32;2020-10-05;-211552
2020-10-04;"Trenčiansky kraj";37;0;0;0;NA;90391;37;2020-10-04;-211584
2020-10-03;"Trenčiansky kraj";79;0;0;0;NA;90391;79;2020-10-03;-211621
2020-10-02;"Trenčiansky kraj";69;0;0;0;NA;90391;69;2020-10-02;-211700
2020-10-01;"Trenčiansky kraj";58;0;0;0;NA;90391;58;2020-10-01;-211769
2020-09-30;"Trenčiansky kraj";76;0;0;0;NA;90391;76;2020-09-30;-211827
2020-09-29;"Trenčiansky kraj";43;0;0;0;NA;90391;43;2020-09-29;-211903
2020-09-28;"Trenčiansky kraj";7;0;0;0;NA;90391;7;2020-09-28;-211946
2020-09-27;"Trenčiansky kraj";12;0;0;0;NA;90391;12;2020-09-27;-211953
2020-09-26;"Trenčiansky kraj";37;0;0;0;NA;90391;37;2020-09-26;-211965
2020-09-25;"Trenčiansky kraj";72;0;0;0;NA;90391;72;2020-09-25;-212002
2020-09-24;"Trenčiansky kraj";41;0;0;0;NA;90391;41;2020-09-24;-212074
2020-09-23;"Trenčiansky kraj";32;0;0;0;NA;90391;32;2020-09-23;-212115
2020-09-22;"Trenčiansky kraj";26;0;0;0;NA;90391;26;2020-09-22;-212147
2020-09-21;"Trenčiansky kraj";23;0;0;0;NA;90391;23;2020-09-21;-212173
2020-09-20;"Trenčiansky kraj";21;0;0;0;NA;90391;21;2020-09-20;-212196
2020-09-19;"Trenčiansky kraj";20;0;0;0;NA;90391;20;2020-09-19;-212217
2020-09-18;"Trenčiansky kraj";41;0;0;0;NA;90391;41;2020-09-18;-212237
2020-09-17;"Trenčiansky kraj";20;0;0;0;NA;90391;20;2020-09-17;-212278
2020-09-16;"Trenčiansky kraj";14;0;0;0;NA;90391;14;2020-09-16;-212298
2020-09-15;"Trenčiansky kraj";8;0;0;0;NA;90391;8;2020-09-15;-212312
2020-09-14;"Trenčiansky kraj";5;0;0;0;NA;90391;5;2020-09-14;-212320
2020-09-13;"Trenčiansky kraj";12;0;0;0;NA;90391;12;2020-09-13;-212325
2020-09-12;"Trenčiansky kraj";2;0;0;0;NA;90391;2;2020-09-12;-212337
2020-09-11;"Trenčiansky kraj";27;0;0;0;NA;90391;27;2020-09-11;-212339
2020-09-10;"Trenčiansky kraj";15;0;0;0;NA;90391;15;2020-09-10;-212366
2020-09-09;"Trenčiansky kraj";11;0;0;0;NA;90391;11;2020-09-09;-212381
2020-09-08;"Trenčiansky kraj";12;0;0;0;NA;90391;12;2020-09-08;-212392
2020-09-07;"Trenčiansky kraj";6;0;0;0;NA;90391;6;2020-09-07;-212404
2020-09-06;"Trenčiansky kraj";1;0;0;0;NA;90391;1;2020-09-06;-212410
2020-09-05;"Trenčiansky kraj";3;0;0;0;NA;90391;3;2020-09-05;-212411
2020-09-04;"Trenčiansky kraj";9;0;0;0;NA;90391;9;2020-09-04;-212414
2020-09-03;"Trenčiansky kraj";10;0;0;0;NA;90391;10;2020-09-03;-212423
2020-09-02;"Trenčiansky kraj";5;0;0;0;NA;90391;5;2020-09-02;-212433
2020-09-01;"Trenčiansky kraj";1;0;0;0;NA;90391;1;2020-09-01;-212438
2020-08-31;"Trenčiansky kraj";12;0;0;0;NA;90391;12;2020-08-31;-212439
2020-08-30;"Trenčiansky kraj";0;0;0;0;NA;90391;0;2020-08-30;-212451
2020-08-29;"Trenčiansky kraj";1;0;0;0;NA;90391;1;2020-08-29;-212451
2020-08-28;"Trenčiansky kraj";12;0;0;0;NA;90391;12;2020-08-28;-212452
2020-08-27;"Trenčiansky kraj";10;0;0;0;NA;90391;10;2020-08-27;-212464
2020-08-26;"Trenčiansky kraj";15;0;0;0;NA;90391;15;2020-08-26;-212474
2020-08-25;"Trenčiansky kraj";12;0;0;0;NA;90391;12;2020-08-25;-212489
2020-08-24;"Trenčiansky kraj";4;0;0;0;NA;90391;4;2020-08-24;-212501
2020-08-23;"Trenčiansky kraj";5;0;0;0;NA;90391;5;2020-08-23;-212505
2020-08-22;"Trenčiansky kraj";6;0;0;0;NA;90391;6;2020-08-22;-212510
2020-08-21;"Trenčiansky kraj";6;0;0;0;NA;90391;6;2020-08-21;-212516
2020-08-20;"Trenčiansky kraj";20;0;0;0;NA;90391;20;2020-08-20;-212522
2020-08-19;"Trenčiansky kraj";17;0;0;0;NA;90391;17;2020-08-19;-212542
2020-08-18;"Trenčiansky kraj";9;0;0;0;NA;90391;9;2020-08-18;-212559
2020-08-17;"Trenčiansky kraj";4;0;0;0;NA;90391;4;2020-08-17;-212568
2020-08-16;"Trenčiansky kraj";0;0;0;0;NA;90391;0;2020-08-16;-212572
2020-08-15;"Trenčiansky kraj";9;0;0;0;NA;90391;9;2020-08-15;-212572
2020-08-14;"Trenčiansky kraj";15;0;0;0;NA;90391;15;2020-08-14;-212581
2020-08-13;"Trenčiansky kraj";23;0;0;0;NA;90391;23;2020-08-13;-212596
2020-08-12;"Trenčiansky kraj";6;0;0;0;NA;90391;6;2020-08-12;-212619
2020-08-11;"Trenčiansky kraj";7;0;0;0;NA;90391;7;2020-08-11;-212625
2020-08-10;"Trenčiansky kraj";9;0;0;0;NA;90391;9;2020-08-10;-212632
2020-08-09;"Trenčiansky kraj";1;0;0;0;NA;90391;1;2020-08-09;-212641
2020-08-08;"Trenčiansky kraj";4;0;0;0;NA;90391;4;2020-08-08;-212642
2020-08-07;"Trenčiansky kraj";4;0;0;0;NA;90391;4;2020-08-07;-212646
2020-08-06;"Trenčiansky kraj";13;0;0;0;NA;90391;13;2020-08-06;-212650
2020-08-05;"Trenčiansky kraj";39;0;0;0;NA;90391;39;2020-08-05;-212663
2020-08-04;"Trenčiansky kraj";9;0;0;0;NA;90391;9;2020-08-04;-212702
2020-08-03;"Trenčiansky kraj";0;0;0;0;NA;90391;0;2020-08-03;-212711
2020-08-02;"Trenčiansky kraj";2;0;0;0;NA;90391;2;2020-08-02;-212711
2020-08-01;"Trenčiansky kraj";6;0;0;0;NA;90391;6;2020-08-01;-212713
2020-07-31;"Trenčiansky kraj";16;0;0;0;NA;90391;16;2020-07-31;-212719
2020-07-30;"Trenčiansky kraj";4;0;0;0;NA;90391;4;2020-07-30;-212735
2020-07-29;"Trenčiansky kraj";5;0;0;0;NA;90391;5;2020-07-29;-212739
2020-07-28;"Trenčiansky kraj";11;0;0;0;NA;90391;11;2020-07-28;-212744
2020-07-27;"Trenčiansky kraj";4;0;0;0;NA;90391;4;2020-07-27;-212755
2020-07-26;"Trenčiansky kraj";1;0;0;0;NA;90391;1;2020-07-26;-212759
2020-07-25;"Trenčiansky kraj";7;0;0;0;NA;90391;7;2020-07-25;-212760
2020-07-24;"Trenčiansky kraj";5;0;0;0;NA;90391;5;2020-07-24;-212767
2020-07-23;"Trenčiansky kraj";10;0;0;0;NA;90391;10;2020-07-23;-212772
2020-07-22;"Trenčiansky kraj";11;0;0;0;NA;90391;11;2020-07-22;-212782
2020-07-21;"Trenčiansky kraj";6;0;0;0;NA;90391;6;2020-07-21;-212793
2020-07-20;"Trenčiansky kraj";13;0;0;0;NA;90391;13;2020-07-20;-212799
2020-07-19;"Trenčiansky kraj";0;0;0;0;NA;90391;0;2020-07-19;-212812
2020-07-18;"Trenčiansky kraj";0;0;0;0;NA;90391;0;2020-07-18;-212812
2020-07-17;"Trenčiansky kraj";1;0;0;0;NA;90391;1;2020-07-17;-212812
2020-07-16;"Trenčiansky kraj";0;0;0;0;NA;90391;0;2020-07-16;-212813
2020-07-15;"Trenčiansky kraj";2;0;0;0;NA;90391;2;2020-07-15;-212813
2020-07-14;"Trenčiansky kraj";8;0;0;0;NA;90391;8;2020-07-14;-212815
2020-07-13;"Trenčiansky kraj";1;0;0;0;NA;90391;1;2020-07-13;-212823
2020-07-12;"Trenčiansky kraj";0;0;0;0;NA;90391;0;2020-07-12;-212824
2020-07-11;"Trenčiansky kraj";0;0;0;0;NA;90391;0;2020-07-11;-212824
2020-07-10;"Trenčiansky kraj";3;0;0;0;NA;90391;3;2020-07-10;-212824
2020-07-09;"Trenčiansky kraj";2;0;0;0;NA;90391;2;2020-07-09;-212827
2020-07-08;"Trenčiansky kraj";1;0;0;0;NA;90391;1;2020-07-08;-212829
2020-07-07;"Trenčiansky kraj";9;0;0;0;NA;90391;9;2020-07-07;-212830
2020-07-06;"Trenčiansky kraj";1;0;0;0;NA;90391;1;2020-07-06;-212839
2020-07-05;"Trenčiansky kraj";1;0;0;0;NA;90391;1;2020-07-05;-212840
2020-07-04;"Trenčiansky kraj";0;0;0;0;NA;90391;0;2020-07-04;-212841
2020-07-03;"Trenčiansky kraj";2;0;0;0;NA;90391;2;2020-07-03;-212841
2020-07-02;"Trenčiansky kraj";10;0;0;0;NA;90391;10;2020-07-02;-212843
2020-07-01;"Trenčiansky kraj";1;0;0;0;NA;90391;1;2020-07-01;-212853
2020-06-30;"Trenčiansky kraj";6;0;0;0;NA;90391;6;2020-06-30;-212854
2020-06-29;"Trenčiansky kraj";1;0;0;0;NA;90391;1;2020-06-29;-212860
2020-06-28;"Trenčiansky kraj";0;0;0;0;NA;90391;0;2020-06-28;-212861
2020-06-27;"Trenčiansky kraj";0;0;0;0;NA;90391;0;2020-06-27;-212861
2020-06-26;"Trenčiansky kraj";0;0;0;0;NA;90391;0;2020-06-26;-212861
2020-06-25;"Trenčiansky kraj";2;0;0;0;NA;90391;2;2020-06-25;-212861
2020-06-24;"Trenčiansky kraj";1;0;0;0;NA;90391;1;2020-06-24;-212863
2020-06-23;"Trenčiansky kraj";0;0;0;0;NA;90391;0;2020-06-23;-212864
2020-06-22;"Trenčiansky kraj";0;0;0;0;NA;90391;0;2020-06-22;-212864
2020-06-21;"Trenčiansky kraj";0;0;0;0;NA;90391;0;2020-06-21;-212864
2020-06-20;"Trenčiansky kraj";0;0;0;0;NA;90391;0;2020-06-20;-212864
2020-06-19;"Trenčiansky kraj";0;0;0;0;NA;90391;0;2020-06-19;-212864
2020-06-18;"Trenčiansky kraj";0;0;0;0;NA;90391;0;2020-06-18;-212864
2020-06-17;"Trenčiansky kraj";0;0;0;0;NA;90391;0;2020-06-17;-212864
2020-06-16;"Trenčiansky kraj";0;0;0;0;NA;90391;0;2020-06-16;-212864
2020-06-14;"Trenčiansky kraj";0;0;0;0;NA;90391;0;2020-06-14;-212864
2020-06-13;"Trenčiansky kraj";0;0;0;0;NA;90391;0;2020-06-13;-212864
2020-06-12;"Trenčiansky kraj";0;0;0;0;NA;90391;0;2020-06-12;-212864
2020-06-11;"Trenčiansky kraj";0;0;0;0;NA;90391;0;2020-06-11;-212864
2020-06-10;"Trenčiansky kraj";1;0;0;0;NA;90391;1;2020-06-10;-212864
2020-06-09;"Trenčiansky kraj";0;0;0;0;NA;90391;0;2020-06-09;-212865
2020-06-08;"Trenčiansky kraj";0;0;0;0;NA;90391;0;2020-06-08;-212865
2020-06-07;"Trenčiansky kraj";0;0;0;0;NA;90391;0;2020-06-07;-212865
2020-06-05;"Trenčiansky kraj";0;0;0;0;NA;90391;0;2020-06-05;-212865
2020-06-03;"Trenčiansky kraj";0;0;0;0;NA;90391;0;2020-06-03;-212865
2020-06-02;"Trenčiansky kraj";0;0;0;0;NA;90391;0;2020-06-02;-212865
2020-05-31;"Trenčiansky kraj";0;0;0;0;NA;90391;0;2020-05-31;-212865
2020-05-29;"Trenčiansky kraj";0;0;0;0;NA;90391;0;2020-05-29;-212865
2020-05-27;"Trenčiansky kraj";2;0;0;0;NA;90391;2;2020-05-27;-212865
2020-05-26;"Trenčiansky kraj";0;0;0;0;NA;90391;0;2020-05-26;-212867
2020-05-25;"Trenčiansky kraj";0;0;0;0;NA;90391;0;2020-05-25;-212867
2020-05-24;"Trenčiansky kraj";0;0;0;0;NA;90391;0;2020-05-24;-212867
2020-05-23;"Trenčiansky kraj";0;0;0;0;NA;90391;0;2020-05-23;-212867
2020-05-22;"Trenčiansky kraj";0;0;0;0;NA;90391;0;2020-05-22;-212867
2020-05-21;"Trenčiansky kraj";0;0;0;0;NA;90391;0;2020-05-21;-212867
2020-05-20;"Trenčiansky kraj";0;0;0;0;NA;90391;0;2020-05-20;-212867
2020-05-19;"Trenčiansky kraj";0;0;0;0;NA;90391;0;2020-05-19;-212867
2020-05-17;"Trenčiansky kraj";0;0;0;0;NA;90391;0;2020-05-17;-212867
2020-05-16;"Trenčiansky kraj";0;0;0;0;NA;90391;0;2020-05-16;-212867
2020-05-15;"Trenčiansky kraj";1;0;0;0;NA;90391;1;2020-05-15;-212867
2020-05-14;"Trenčiansky kraj";2;0;0;0;NA;90391;2;2020-05-14;-212868
2020-05-13;"Trenčiansky kraj";1;0;0;0;NA;90391;1;2020-05-13;-212870
2020-05-12;"Trenčiansky kraj";1;0;0;0;NA;90391;1;2020-05-12;-212871
2020-05-11;"Trenčiansky kraj";3;0;0;0;NA;90391;3;2020-05-11;-212872
2020-05-09;"Trenčiansky kraj";2;0;0;0;NA;90391;2;2020-05-09;-212875
2020-05-07;"Trenčiansky kraj";6;0;0;0;NA;90391;6;2020-05-07;-212877
2020-05-06;"Trenčiansky kraj";0;0;0;0;NA;90391;0;2020-05-06;-212883
2020-05-05;"Trenčiansky kraj";2;0;0;0;NA;90391;2;2020-05-05;-212883
2020-05-04;"Trenčiansky kraj";0;0;0;0;NA;90391;0;2020-05-04;-212885
2020-05-03;"Trenčiansky kraj";0;0;0;0;NA;90391;0;2020-05-03;-212885
2020-05-02;"Trenčiansky kraj";0;0;0;0;NA;90391;0;2020-05-02;-212885
2020-05-01;"Trenčiansky kraj";0;0;0;0;NA;90391;0;2020-05-01;-212885
2020-04-30;"Trenčiansky kraj";0;0;0;0;NA;90391;0;2020-04-30;-212885
2020-04-29;"Trenčiansky kraj";2;0;0;0;NA;90391;2;2020-04-29;-212885
2020-04-28;"Trenčiansky kraj";1;0;0;0;NA;90391;1;2020-04-28;-212887
2020-04-27;"Trenčiansky kraj";0;0;0;0;NA;90391;0;2020-04-27;-212888
2020-04-26;"Trenčiansky kraj";1;0;0;0;NA;90391;1;2020-04-26;-212888
2020-04-25;"Trenčiansky kraj";0;0;0;0;NA;90391;0;2020-04-25;-212889
2020-04-24;"Trenčiansky kraj";0;0;0;0;NA;90391;0;2020-04-24;-212889
2020-04-23;"Trenčiansky kraj";11;0;0;0;NA;90391;11;2020-04-23;-212889
2020-04-22;"Trenčiansky kraj";1;0;0;0;NA;90391;1;2020-04-22;-212900
2020-04-21;"Trenčiansky kraj";11;0;0;0;NA;90391;11;2020-04-21;-212901
2020-04-20;"Trenčiansky kraj";15;0;0;0;NA;90391;15;2020-04-20;-212912
2020-04-19;"Trenčiansky kraj";2;0;0;0;NA;90391;2;2020-04-19;-212927
2020-04-18;"Trenčiansky kraj";3;0;0;0;NA;90391;3;2020-04-18;-212929
2020-04-17;"Trenčiansky kraj";4;0;0;0;NA;90391;4;2020-04-17;-212932
2020-04-16;"Trenčiansky kraj";10;0;0;0;NA;90391;10;2020-04-16;-212936
2020-04-15;"Trenčiansky kraj";4;0;0;0;NA;90391;4;2020-04-15;-212946
2020-04-14;"Trenčiansky kraj";0;0;0;0;NA;90391;0;2020-04-14;-212950
2020-04-13;"Trenčiansky kraj";1;0;0;0;NA;90391;1;2020-04-13;-212950
2020-04-12;"Trenčiansky kraj";2;0;0;0;NA;90391;2;2020-04-12;-212951
2020-04-11;"Trenčiansky kraj";3;0;0;0;NA;90391;3;2020-04-11;-212953
2020-04-10;"Trenčiansky kraj";0;0;0;0;NA;90391;0;2020-04-10;-212956
2020-04-09;"Trenčiansky kraj";0;0;0;0;NA;90391;0;2020-04-09;-212956
2020-04-08;"Trenčiansky kraj";2;0;0;0;NA;90391;2;2020-04-08;-212956
2020-04-07;"Trenčiansky kraj";18;0;0;0;NA;90391;18;2020-04-07;-212958
2020-04-06;"Trenčiansky kraj";0;0;0;0;NA;90391;0;2020-04-06;-212976
2020-04-05;"Trenčiansky kraj";3;0;0;0;NA;90391;3;2020-04-05;-212976
2020-04-04;"Trenčiansky kraj";5;0;0;0;NA;90391;5;2020-04-04;-212979
2020-04-03;"Trenčiansky kraj";4;0;0;0;NA;90391;4;2020-04-03;-212984
2020-04-02;"Trenčiansky kraj";1;0;0;0;NA;90391;1;2020-04-02;-212988
2020-04-01;"Trenčiansky kraj";3;0;0;0;NA;90391;3;2020-04-01;-212989
2020-03-31;"Trenčiansky kraj";1;0;0;0;NA;90391;1;2020-03-31;-212992
2020-03-30;"Trenčiansky kraj";3;0;0;0;NA;90391;3;2020-03-30;-212993
2020-03-29;"Trenčiansky kraj";6;0;0;0;NA;90391;6;2020-03-29;-212996
2020-03-28;"Trenčiansky kraj";9;0;0;0;NA;90391;9;2020-03-28;-213002
2020-03-27;"Trenčiansky kraj";2;0;0;0;NA;90391;2;2020-03-27;-213011
2020-03-26;"Trenčiansky kraj";6;0;0;0;NA;90391;6;2020-03-26;-213013
2020-03-25;"Trenčiansky kraj";3;0;0;0;NA;90391;3;2020-03-25;-213019
2020-03-24;"Trenčiansky kraj";1;0;0;0;NA;90391;1;2020-03-24;-213022
2020-03-23;"Trenčiansky kraj";0;0;0;0;NA;90391;0;2020-03-23;-213023
2020-03-22;"Trenčiansky kraj";0;0;0;0;NA;90391;0;2020-03-22;-213023
2020-03-21;"Trenčiansky kraj";2;0;0;0;NA;90391;2;2020-03-21;-213023
2020-03-20;"Trenčiansky kraj";2;0;0;0;NA;90391;2;2020-03-20;-213025
2020-03-19;"Trenčiansky kraj";8;0;0;0;NA;90391;8;2020-03-19;-213027
2020-03-18;"Trenčiansky kraj";0;0;0;0;NA;90391;0;2020-03-18;-213035
2020-03-17;"Trenčiansky kraj";0;0;0;0;NA;90391;0;2020-03-17;-213035
2020-03-16;"Trenčiansky kraj";1;0;0;0;NA;90391;1;2020-03-16;-213035
2020-03-15;"Trenčiansky kraj";5;0;0;0;NA;90391;5;2020-03-15;-213036
2020-03-14;"Trenčiansky kraj";0;0;0;0;NA;90391;0;2020-03-14;-213041
2020-03-13;"Trenčiansky kraj";0;0;0;0;NA;90391;0;2020-03-13;-213041
2020-03-12;"Trenčiansky kraj";1;0;0;0;NA;90391;1;2020-03-12;-213041
2020-03-11;"Trenčiansky kraj";0;0;0;0;NA;90391;0;2020-03-11;-213042
2020-03-09;"Trenčiansky kraj";0;0;0;0;NA;90391;0;2020-03-09;-213042
2020-03-08;"Trenčiansky kraj";0;0;0;0;NA;90391;0;2020-03-08;-213042
2020-03-07;"Trenčiansky kraj";0;0;0;0;NA;90391;0;2020-03-07;-213042
2020-03-06;"Trenčiansky kraj";0;0;0;0;NA;90391;0;2020-03-06;-213042
2022-06-26;"Trnavský kraj";3;12;1;13;NA;69457;4;2022-06-26;69457
2022-06-25;"Trnavský kraj";16;15;1;16;NA;69457;17;2022-06-25;69453
2022-06-24;"Trnavský kraj";48;134;6;140;NA;69457;54;2022-06-24;69436
2022-06-23;"Trnavský kraj";40;108;5;113;NA;69457;45;2022-06-23;69382
2022-06-22;"Trnavský kraj";25;141;5;146;NA;69457;30;2022-06-22;69337
2022-06-21;"Trnavský kraj";31;116;2;118;NA;69457;33;2022-06-21;69307
2022-06-20;"Trnavský kraj";19;240;7;247;NA;69457;26;2022-06-20;69274
2022-06-19;"Trnavský kraj";0;26;0;26;NA;69457;0;2022-06-19;69248
2022-06-18;"Trnavský kraj";11;19;2;21;NA;69457;13;2022-06-18;69248
2022-06-17;"Trnavský kraj";16;95;6;101;NA;69457;22;2022-06-17;69235
2022-06-16;"Trnavský kraj";8;119;2;121;NA;69457;10;2022-06-16;69213
2022-06-15;"Trnavský kraj";8;111;2;113;NA;69457;10;2022-06-15;69203
2022-06-14;"Trnavský kraj";32;151;0;151;NA;69457;32;2022-06-14;69193
2022-06-13;"Trnavský kraj";25;175;6;181;NA;69457;31;2022-06-13;69161
2022-06-12;"Trnavský kraj";1;82;2;84;NA;69457;3;2022-06-12;69130
2022-06-11;"Trnavský kraj";7;34;0;34;NA;69457;7;2022-06-11;69127
2022-06-10;"Trnavský kraj";10;128;2;130;NA;69457;12;2022-06-10;69120
2022-06-09;"Trnavský kraj";15;129;2;131;NA;69457;17;2022-06-09;69108
2022-06-08;"Trnavský kraj";18;116;2;118;NA;69457;20;2022-06-08;69091
2022-06-07;"Trnavský kraj";19;137;2;139;NA;69457;21;2022-06-07;69071
2022-06-06;"Trnavský kraj";9;194;2;196;NA;69457;11;2022-06-06;69050
2022-06-05;"Trnavský kraj";0;34;3;37;NA;69457;3;2022-06-05;69039
2022-06-04;"Trnavský kraj";7;26;0;26;NA;69457;7;2022-06-04;69036
2022-06-03;"Trnavský kraj";14;136;0;136;NA;69457;14;2022-06-03;69029
2022-06-02;"Trnavský kraj";15;141;3;144;NA;69457;18;2022-06-02;69015
2022-06-01;"Trnavský kraj";7;116;9;125;NA;69457;16;2022-06-01;68997
2022-05-31;"Trnavský kraj";13;150;3;153;NA;69457;16;2022-05-31;68981
2022-05-30;"Trnavský kraj";16;174;1;175;NA;69457;17;2022-05-30;68965
2022-05-29;"Trnavský kraj";0;41;1;42;NA;69457;1;2022-05-29;68948
2022-05-28;"Trnavský kraj";10;46;1;47;NA;69457;11;2022-05-28;68947
2022-05-27;"Trnavský kraj";14;172;3;175;NA;69457;17;2022-05-27;68936
2022-05-26;"Trnavský kraj";9;147;4;151;NA;69457;13;2022-05-26;68919
2022-05-25;"Trnavský kraj";13;159;3;162;NA;69457;16;2022-05-25;68906
2022-05-24;"Trnavský kraj";13;114;1;115;NA;69457;14;2022-05-24;68890
2022-05-23;"Trnavský kraj";17;235;13;248;NA;69457;30;2022-05-23;68876
2022-05-22;"Trnavský kraj";0;50;0;50;NA;69457;0;2022-05-22;68846
2022-05-21;"Trnavský kraj";7;33;1;34;NA;69457;8;2022-05-21;68846
2022-05-20;"Trnavský kraj";12;103;3;106;NA;69457;15;2022-05-20;68838
2022-05-19;"Trnavský kraj";18;125;1;126;NA;69457;19;2022-05-19;68823
2022-05-18;"Trnavský kraj";13;137;7;144;NA;69457;20;2022-05-18;68804
2022-05-17;"Trnavský kraj";16;196;6;202;NA;69457;22;2022-05-17;68784
2022-05-16;"Trnavský kraj";34;206;5;211;NA;69457;39;2022-05-16;68762
2022-05-15;"Trnavský kraj";5;33;2;35;NA;69457;7;2022-05-15;68723
2022-05-14;"Trnavský kraj";16;68;1;69;NA;69457;17;2022-05-14;68716
2022-05-13;"Trnavský kraj";41;203;4;207;NA;69457;45;2022-05-13;68699
2022-05-12;"Trnavský kraj";9;127;6;133;NA;69457;15;2022-05-12;68654
2022-05-11;"Trnavský kraj";41;188;7;195;NA;69457;48;2022-05-11;68639
2022-05-10;"Trnavský kraj";39;184;4;188;NA;69457;43;2022-05-10;68591
2022-05-09;"Trnavský kraj";35;258;15;273;NA;69457;50;2022-05-09;68548
2022-05-08;"Trnavský kraj";4;44;0;44;NA;69457;4;2022-05-08;68498
2022-05-07;"Trnavský kraj";26;39;6;45;NA;69457;32;2022-05-07;68494
2022-05-06;"Trnavský kraj";42;248;10;258;NA;69457;52;2022-05-06;68462
2022-05-05;"Trnavský kraj";49;182;9;191;NA;69457;58;2022-05-05;68410
2022-05-04;"Trnavský kraj";76;179;8;187;NA;69457;84;2022-05-04;68352
2022-05-03;"Trnavský kraj";97;186;4;190;NA;69457;101;2022-05-03;68268
2022-05-02;"Trnavský kraj";104;287;10;297;NA;69457;114;2022-05-02;68167
2022-05-01;"Trnavský kraj";14;60;1;61;NA;69457;15;2022-05-01;68053
2022-04-30;"Trnavský kraj";53;46;3;49;NA;69457;56;2022-04-30;68038
2022-04-29;"Trnavský kraj";84;172;7;179;NA;69457;91;2022-04-29;67982
2022-04-28;"Trnavský kraj";147;326;12;338;NA;69457;159;2022-04-28;67891
2022-04-27;"Trnavský kraj";125;457;24;481;NA;69457;149;2022-04-27;67732
2022-04-26;"Trnavský kraj";135;213;9;222;NA;69457;144;2022-04-26;67583
2022-04-25;"Trnavský kraj";154;354;15;369;NA;69457;169;2022-04-25;67439
2022-04-24;"Trnavský kraj";41;60;6;66;NA;69457;47;2022-04-24;67270
2022-04-23;"Trnavský kraj";130;119;8;127;NA;69457;138;2022-04-23;67223
2022-04-22;"Trnavský kraj";157;393;20;413;NA;69457;177;2022-04-22;67085
2022-04-21;"Trnavský kraj";238;540;16;556;NA;69457;254;2022-04-21;66908
2022-04-20;"Trnavský kraj";164;390;25;415;NA;69457;189;2022-04-20;66654
2022-04-19;"Trnavský kraj";223;536;31;567;NA;69457;254;2022-04-19;66465
2022-04-18;"Trnavský kraj";66;63;9;72;NA;69457;75;2022-04-18;66211
2022-04-17;"Trnavský kraj";116;65;4;69;NA;69457;120;2022-04-17;66136
2022-04-16;"Trnavský kraj";99;103;9;112;NA;69457;108;2022-04-16;66016
2022-04-15;"Trnavský kraj";193;113;2;115;NA;69457;195;2022-04-15;65908
2022-04-14;"Trnavský kraj";237;610;42;652;NA;69457;279;2022-04-14;65713
2022-04-13;"Trnavský kraj";298;385;26;411;NA;69457;324;2022-04-13;65434
2022-04-12;"Trnavský kraj";358;492;39;531;NA;69457;397;2022-04-12;65110
2022-04-11;"Trnavský kraj";265;601;37;638;NA;69457;302;2022-04-11;64713
2022-04-10;"Trnavský kraj";124;128;19;147;NA;69457;143;2022-04-10;64411
2022-04-09;"Trnavský kraj";324;66;5;71;NA;69457;329;2022-04-09;64268
2022-04-08;"Trnavský kraj";380;388;43;431;NA;69457;423;2022-04-08;63939
2022-04-07;"Trnavský kraj";405;363;33;396;NA;69457;438;2022-04-07;63516
2022-04-06;"Trnavský kraj";485;380;35;415;NA;69457;520;2022-04-06;63078
2022-04-05;"Trnavský kraj";549;401;49;450;NA;69457;598;2022-04-05;62558
2022-04-04;"Trnavský kraj";621;707;90;797;NA;69457;711;2022-04-04;61960
2022-04-03;"Trnavský kraj";35;126;22;148;NA;69457;57;2022-04-03;61249
2022-04-02;"Trnavský kraj";478;113;14;127;NA;69457;492;2022-04-02;61192
2022-04-01;"Trnavský kraj";630;643;65;708;NA;69457;695;2022-04-01;60700
2022-03-31;"Trnavský kraj";709;483;69;552;NA;69457;778;2022-03-31;60005
2022-03-30;"Trnavský kraj";885;518;75;593;NA;69457;960;2022-03-30;59227
2022-03-29;"Trnavský kraj";845;667;75;742;NA;69457;920;2022-03-29;58267
2022-03-28;"Trnavský kraj";623;795;117;912;NA;69457;740;2022-03-28;57347
2022-03-27;"Trnavský kraj";340;185;39;224;NA;69457;379;2022-03-27;56607
2022-03-26;"Trnavský kraj";762;214;36;250;NA;69457;798;2022-03-26;56228
2022-03-25;"Trnavský kraj";859;664;69;733;NA;69457;928;2022-03-25;55430
2022-03-24;"Trnavský kraj";920;638;73;711;NA;69457;993;2022-03-24;54502
2022-03-23;"Trnavský kraj";1112;794;96;890;NA;69457;1208;2022-03-23;53509
2022-03-22;"Trnavský kraj";1096;767;70;837;NA;69457;1166;2022-03-22;52301
2022-03-21;"Trnavský kraj";1096;1025;113;1138;NA;69457;1209;2022-03-21;51135
2022-03-20;"Trnavský kraj";229;262;46;308;NA;69457;275;2022-03-20;49926
2022-03-19;"Trnavský kraj";1000;237;57;294;NA;69457;1057;2022-03-19;49651
2022-03-18;"Trnavský kraj";1038;907;107;1014;NA;69457;1145;2022-03-18;48594
2022-03-17;"Trnavský kraj";1148;721;93;814;NA;69457;1241;2022-03-17;47449
2022-03-16;"Trnavský kraj";1344;602;87;689;NA;69457;1431;2022-03-16;46208
2022-03-15;"Trnavský kraj";1179;1037;122;1159;NA;69457;1301;2022-03-15;44777
2022-03-14;"Trnavský kraj";890;1545;177;1722;NA;69457;1067;2022-03-14;43476
2022-03-13;"Trnavský kraj";290;422;57;479;NA;69457;347;2022-03-13;42409
2022-03-12;"Trnavský kraj";958;589;113;702;NA;69457;1071;2022-03-12;42062
2022-03-11;"Trnavský kraj";961;1038;126;1164;NA;69457;1087;2022-03-11;40991
2022-03-10;"Trnavský kraj";1049;1247;150;1397;NA;69457;1199;2022-03-10;39904
2022-03-09;"Trnavský kraj";1271;1159;161;1320;NA;69457;1432;2022-03-09;38705
2022-03-08;"Trnavský kraj";1393;1361;179;1540;NA;69457;1572;2022-03-08;37273
2022-03-07;"Trnavský kraj";1005;2051;263;2314;NA;69457;1268;2022-03-07;35701
2022-03-06;"Trnavský kraj";395;565;118;683;NA;69457;513;2022-03-06;34433
2022-03-05;"Trnavský kraj";806;475;90;565;NA;69457;896;2022-03-05;33920
2022-03-04;"Trnavský kraj";1028;1063;126;1189;NA;69457;1154;2022-03-04;33024
2022-03-03;"Trnavský kraj";1513;1135;168;1303;NA;69457;1681;2022-03-03;31870
2022-03-02;"Trnavský kraj";1330;1513;194;1707;NA;69457;1524;2022-03-02;30189
2022-03-01;"Trnavský kraj";1527;1351;201;1552;NA;69457;1728;2022-03-01;28665
2022-02-28;"Trnavský kraj";1318;2105;264;2369;NA;69457;1582;2022-02-28;26937
2022-02-27;"Trnavský kraj";386;640;106;746;NA;69457;492;2022-02-27;25355
2022-02-26;"Trnavský kraj";1268;526;112;638;NA;69457;1380;2022-02-26;24863
2022-02-25;"Trnavský kraj";1439;1491;211;1702;NA;69457;1650;2022-02-25;23483
2022-02-24;"Trnavský kraj";1397;1421;183;1604;NA;69457;1580;2022-02-24;21833
2022-02-23;"Trnavský kraj";2032;1668;240;1908;NA;69457;2272;2022-02-23;20253
2022-02-22;"Trnavský kraj";2171;1891;271;2162;NA;69457;2442;2022-02-22;17981
2022-02-21;"Trnavský kraj";1983;2849;438;3287;NA;69457;2421;2022-02-21;15539
2022-02-20;"Trnavský kraj";888;830;187;1017;NA;69457;1075;2022-02-20;13118
2022-02-19;"Trnavský kraj";1838;712;149;861;NA;69457;1987;2022-02-19;12043
2022-02-18;"Trnavský kraj";2132;1733;269;2002;NA;69457;2401;2022-02-18;10056
2022-02-17;"Trnavský kraj";1987;1764;269;2033;NA;69457;2256;2022-02-17;7655
2022-02-16;"Trnavský kraj";2047;1809;317;2126;NA;69457;2364;2022-02-16;5399
2022-02-15;"Trnavský kraj";2228;2412;400;2812;NA;69457;2628;2022-02-15;3035
2022-02-14;"Trnavský kraj";2216;3425;492;3917;NA;69457;2708;2022-02-14;407
2022-02-13;"Trnavský kraj";805;1129;247;1376;NA;69457;1052;2022-02-13;-2301
2022-02-12;"Trnavský kraj";2081;966;175;1141;NA;69457;2256;2022-02-12;-3353
2022-02-11;"Trnavský kraj";1665;2158;266;2424;NA;69457;1931;2022-02-11;-5609
2022-02-10;"Trnavský kraj";2491;1942;256;2198;NA;69457;2747;2022-02-10;-7540
2022-02-09;"Trnavský kraj";2205;2474;365;2839;NA;69457;2570;2022-02-09;-10287
2022-02-08;"Trnavský kraj";1758;2352;353;2705;NA;69457;2111;2022-02-08;-12857
2022-02-07;"Trnavský kraj";2581;3356;459;3815;NA;69457;3040;2022-02-07;-14968
2022-02-06;"Trnavský kraj";1194;1309;276;1585;NA;69457;1470;2022-02-06;-18008
2022-02-05;"Trnavský kraj";2165;1102;187;1289;NA;69457;2352;2022-02-05;-19478
2022-02-04;"Trnavský kraj";2191;2179;253;2432;NA;69457;2444;2022-02-04;-21830
2022-02-03;"Trnavský kraj";2124;3295;347;3642;NA;69457;2471;2022-02-03;-24274
2022-02-02;"Trnavský kraj";1812;2684;281;2965;NA;69457;2093;2022-02-02;-26745
2022-02-01;"Trnavský kraj";2344;2656;318;2974;NA;69457;2662;2022-02-01;-28838
2022-01-31;"Trnavský kraj";1931;5001;489;5490;NA;69457;2420;2022-01-31;-31500
2022-01-30;"Trnavský kraj";709;1672;176;1848;NA;69457;885;2022-01-30;-33920
2022-01-29;"Trnavský kraj";2136;1174;159;1333;NA;69457;2295;2022-01-29;-34805
2022-01-28;"Trnavský kraj";1734;2340;216;2556;NA;69457;1950;2022-01-28;-37100
2022-01-27;"Trnavský kraj";1989;2333;246;2579;NA;69457;2235;2022-01-27;-39050
2022-01-26;"Trnavský kraj";1906;2730;217;2947;NA;69457;2123;2022-01-26;-41285
2022-01-25;"Trnavský kraj";1631;2422;195;2617;NA;69457;1826;2022-01-25;-43408
2022-01-24;"Trnavský kraj";999;4194;236;4430;NA;69457;1235;2022-01-24;-45234
2022-01-23;"Trnavský kraj";299;1897;105;2002;NA;69457;404;2022-01-23;-46469
2022-01-22;"Trnavský kraj";1169;1197;81;1278;NA;69457;1250;2022-01-22;-46873
2022-01-21;"Trnavský kraj";830;2134;104;2238;NA;69457;934;2022-01-21;-48123
2022-01-20;"Trnavský kraj";917;2511;100;2611;NA;69457;1017;2022-01-20;-49057
2022-01-19;"Trnavský kraj";832;2122;84;2206;NA;69457;916;2022-01-19;-50074
2022-01-18;"Trnavský kraj";704;2051;74;2125;NA;69457;778;2022-01-18;-50990
2022-01-17;"Trnavský kraj";366;3885;87;3972;NA;69457;453;2022-01-17;-51768
2022-01-16;"Trnavský kraj";84;1696;44;1740;NA;69457;128;2022-01-16;-52221
2022-01-15;"Trnavský kraj";421;1015;33;1048;NA;69457;454;2022-01-15;-52349
2022-01-14;"Trnavský kraj";349;2040;50;2090;NA;69457;399;2022-01-14;-52803
2022-01-13;"Trnavský kraj";234;2057;52;2109;NA;69457;286;2022-01-13;-53202
2022-01-12;"Trnavský kraj";400;1927;35;1962;NA;69457;435;2022-01-12;-53488
2022-01-11;"Trnavský kraj";384;2261;33;2294;NA;69457;417;2022-01-11;-53923
2022-01-10;"Trnavský kraj";258;4357;71;4428;NA;69457;329;2022-01-10;-54340
2022-01-09;"Trnavský kraj";35;1921;22;1943;NA;69457;57;2022-01-09;-54669
2022-01-08;"Trnavský kraj";364;1005;29;1034;NA;69457;393;2022-01-08;-54726
2022-01-07;"Trnavský kraj";332;1984;47;2031;NA;69457;379;2022-01-07;-55119
2022-01-06;"Trnavský kraj";234;830;20;850;NA;69457;254;2022-01-06;-55498
2022-01-05;"Trnavský kraj";416;1925;37;1962;NA;69457;453;2022-01-05;-55752
2022-01-04;"Trnavský kraj";538;2337;37;2374;NA;69457;575;2022-01-04;-56205
2022-01-03;"Trnavský kraj";441;3897;65;3962;NA;69457;506;2022-01-03;-56780
2022-01-02;"Trnavský kraj";79;1561;21;1582;NA;69457;100;2022-01-02;-57286
2022-01-01;"Trnavský kraj";4;190;7;197;NA;69457;11;2022-01-01;-57386
2021-12-31;"Trnavský kraj";485;1246;60;1306;NA;69457;545;2021-12-31;-57397
2021-12-30;"Trnavský kraj";401;1927;58;1985;NA;69457;459;2021-12-30;-57942
2021-12-29;"Trnavský kraj";401;1756;70;1826;NA;69457;471;2021-12-29;-58401
2021-12-28;"Trnavský kraj";633;1742;73;1815;NA;69457;706;2021-12-28;-58872
2021-12-27;"Trnavský kraj";463;2814;134;2948;NA;69457;597;2021-12-27;-59578
2021-12-26;"Trnavský kraj";253;1019;30;1049;NA;69457;283;2021-12-26;-60175
2021-12-25;"Trnavský kraj";104;341;41;382;NA;69457;145;2021-12-25;-60458
2021-12-24;"Trnavský kraj";216;369;27;396;NA;69457;243;2021-12-24;-60603
2021-12-23;"Trnavský kraj";570;1825;102;1927;NA;69457;672;2021-12-23;-60846
2021-12-22;"Trnavský kraj";545;1732;81;1813;NA;69457;626;2021-12-22;-61518
2021-12-21;"Trnavský kraj";699;2577;89;2666;NA;69457;788;2021-12-21;-62144
2021-12-20;"Trnavský kraj";438;3941;103;4044;NA;69457;541;2021-12-20;-62932
2021-12-19;"Trnavský kraj";155;1762;63;1825;NA;69457;218;2021-12-19;-63473
2021-12-18;"Trnavský kraj";627;1302;77;1379;NA;69457;704;2021-12-18;-63691
2021-12-17;"Trnavský kraj";576;2276;109;2385;NA;69457;685;2021-12-17;-64395
2021-12-16;"Trnavský kraj";653;2530;123;2653;NA;69457;776;2021-12-16;-65080
2021-12-15;"Trnavský kraj";746;2198;120;2318;NA;69457;866;2021-12-15;-65856
2021-12-14;"Trnavský kraj";976;2718;134;2852;NA;69457;1110;2021-12-14;-66722
2021-12-13;"Trnavský kraj";521;4857;175;5032;NA;69457;696;2021-12-13;-67832
2021-12-12;"Trnavský kraj";337;2117;87;2204;NA;69457;424;2021-12-12;-68528
2021-12-11;"Trnavský kraj";720;1324;83;1407;NA;69457;803;2021-12-11;-68952
2021-12-10;"Trnavský kraj";702;2909;136;3045;NA;69457;838;2021-12-10;-69755
2021-12-09;"Trnavský kraj";926;2313;96;2409;NA;69457;1022;2021-12-09;-70593
2021-12-08;"Trnavský kraj";1233;2547;137;2684;NA;69457;1370;2021-12-08;-71615
2021-12-07;"Trnavský kraj";1159;3637;174;3811;NA;69457;1333;2021-12-07;-72985
2021-12-06;"Trnavský kraj";911;3649;208;3857;NA;69457;1119;2021-12-06;-74318
2021-12-05;"Trnavský kraj";269;2303;106;2409;NA;69457;375;2021-12-05;-75437
2021-12-04;"Trnavský kraj";1225;1623;115;1738;NA;69457;1340;2021-12-04;-75812
2021-12-03;"Trnavský kraj";1246;2998;201;3199;NA;69457;1447;2021-12-03;-77152
2021-12-02;"Trnavský kraj";1809;2379;188;2567;NA;69457;1997;2021-12-02;-78599
2021-12-01;"Trnavský kraj";738;3011;179;3190;NA;69457;917;2021-12-01;-80596
2021-11-30;"Trnavský kraj";1166;4217;202;4419;NA;69457;1368;2021-11-30;-81513
2021-11-29;"Trnavský kraj";814;5360;299;5659;NA;69457;1113;2021-11-29;-82881
2021-11-28;"Trnavský kraj";482;3087;146;3233;NA;69457;628;2021-11-28;-83994
2021-11-27;"Trnavský kraj";1186;2240;206;2446;NA;69457;1392;2021-11-27;-84622
2021-11-26;"Trnavský kraj";880;2895;202;3097;NA;69457;1082;2021-11-26;-86014
2021-11-25;"Trnavský kraj";1002;2680;158;2838;NA;69457;1160;2021-11-25;-87096
2021-11-24;"Trnavský kraj";1060;3442;250;3692;NA;69457;1310;2021-11-24;-88256
2021-11-23;"Trnavský kraj";1078;3714;273;3987;NA;69457;1351;2021-11-23;-89566
2021-11-22;"Trnavský kraj";696;4028;295;4323;NA;69457;991;2021-11-22;-90917
2021-11-21;"Trnavský kraj";298;2270;212;2482;NA;69457;510;2021-11-21;-91908
2021-11-20;"Trnavský kraj";826;1529;196;1725;NA;69457;1022;2021-11-20;-92418
2021-11-19;"Trnavský kraj";901;3369;315;3684;NA;69457;1216;2021-11-19;-93440
2021-11-18;"Trnavský kraj";796;2872;240;3112;NA;69457;1036;2021-11-18;-94656
2021-11-17;"Trnavský kraj";769;1201;139;1340;NA;69457;908;2021-11-17;-95692
2021-11-16;"Trnavský kraj";591;2755;206;2961;NA;69457;797;2021-11-16;-96600
2021-11-15;"Trnavský kraj";606;3350;239;3589;NA;69457;845;2021-11-15;-97397
2021-11-14;"Trnavský kraj";236;1579;141;1720;NA;69457;377;2021-11-14;-98242
2021-11-13;"Trnavský kraj";815;1314;132;1446;NA;69457;947;2021-11-13;-98619
2021-11-12;"Trnavský kraj";563;2585;157;2742;NA;69457;720;2021-11-12;-99566
2021-11-11;"Trnavský kraj";512;2426;161;2587;NA;69457;673;2021-11-11;-100286
2021-11-10;"Trnavský kraj";590;2315;173;2488;NA;69457;763;2021-11-10;-100959
2021-11-09;"Trnavský kraj";585;2538;187;2725;NA;69457;772;2021-11-09;-101722
2021-11-08;"Trnavský kraj";357;2715;163;2878;NA;69457;520;2021-11-08;-102494
2021-11-07;"Trnavský kraj";162;1349;111;1460;NA;69457;273;2021-11-07;-103014
2021-11-06;"Trnavský kraj";391;1287;82;1369;NA;69457;473;2021-11-06;-103287
2021-11-05;"Trnavský kraj";447;2202;102;2304;NA;69457;549;2021-11-05;-103760
2021-11-04;"Trnavský kraj";432;2289;112;2401;NA;69457;544;2021-11-04;-104309
2021-11-03;"Trnavský kraj";420;2091;97;2188;NA;69457;517;2021-11-03;-104853
2021-11-02;"Trnavský kraj";365;2777;124;2901;NA;69457;489;2021-11-02;-105370
2021-11-01;"Trnavský kraj";220;583;27;610;NA;69457;247;2021-11-01;-105859
2021-10-31;"Trnavský kraj";61;887;62;949;NA;69457;123;2021-10-31;-106106
2021-10-30;"Trnavský kraj";251;1099;50;1149;NA;69457;301;2021-10-30;-106229
2021-10-29;"Trnavský kraj";312;2123;53;2176;NA;69457;365;2021-10-29;-106530
2021-10-28;"Trnavský kraj";339;2034;65;2099;NA;69457;404;2021-10-28;-106895
2021-10-27;"Trnavský kraj";232;1884;58;1942;NA;69457;290;2021-10-27;-107299
2021-10-26;"Trnavský kraj";366;1964;54;2018;NA;69457;420;2021-10-26;-107589
2021-10-25;"Trnavský kraj";142;2786;72;2858;NA;69457;214;2021-10-25;-108009
2021-10-24;"Trnavský kraj";11;990;30;1020;NA;69457;41;2021-10-24;-108223
2021-10-23;"Trnavský kraj";228;1126;27;1153;NA;69457;255;2021-10-23;-108264
2021-10-22;"Trnavský kraj";204;2269;51;2320;NA;69457;255;2021-10-22;-108519
2021-10-21;"Trnavský kraj";188;1671;46;1717;NA;69457;234;2021-10-21;-108774
2021-10-20;"Trnavský kraj";212;1634;47;1681;NA;69457;259;2021-10-20;-109008
2021-10-19;"Trnavský kraj";240;1848;30;1878;NA;69457;270;2021-10-19;-109267
2021-10-18;"Trnavský kraj";95;2316;72;2388;NA;69457;167;2021-10-18;-109537
2021-10-17;"Trnavský kraj";5;1218;17;1235;NA;69457;22;2021-10-17;-109704
2021-10-16;"Trnavský kraj";129;1233;17;1250;NA;69457;146;2021-10-16;-109726
2021-10-15;"Trnavský kraj";122;2121;24;2145;NA;69457;146;2021-10-15;-109872
2021-10-14;"Trnavský kraj";131;1663;24;1687;NA;69457;155;2021-10-14;-110018
2021-10-13;"Trnavský kraj";128;2072;23;2095;NA;69457;151;2021-10-13;-110173
2021-10-12;"Trnavský kraj";189;2788;38;2826;NA;69457;227;2021-10-12;-110324
2021-10-11;"Trnavský kraj";115;2621;35;2656;NA;69457;150;2021-10-11;-110551
2021-10-10;"Trnavský kraj";2;993;15;1008;NA;69457;17;2021-10-10;-110701
2021-10-09;"Trnavský kraj";151;1099;10;1109;NA;69457;161;2021-10-09;-110718
2021-10-08;"Trnavský kraj";106;2326;34;2360;NA;69457;140;2021-10-08;-110879
2021-10-07;"Trnavský kraj";151;1744;25;1769;NA;69457;176;2021-10-07;-111019
2021-10-06;"Trnavský kraj";122;1929;27;1956;NA;69457;149;2021-10-06;-111195
2021-10-05;"Trnavský kraj";220;3726;34;3760;NA;69457;254;2021-10-05;-111344
2021-10-04;"Trnavský kraj";54;1963;47;2010;NA;69457;101;2021-10-04;-111598
2021-10-03;"Trnavský kraj";1;1106;17;1123;NA;69457;18;2021-10-03;-111699
2021-10-02;"Trnavský kraj";52;1055;12;1067;NA;69457;64;2021-10-02;-111717
2021-10-01;"Trnavský kraj";113;2243;17;2260;NA;69457;130;2021-10-01;-111781
2021-09-30;"Trnavský kraj";109;1872;18;1890;NA;69457;127;2021-09-30;-111911
2021-09-29;"Trnavský kraj";83;1331;11;1342;NA;69457;94;2021-09-29;-112038
2021-09-28;"Trnavský kraj";135;1934;31;1965;NA;69457;166;2021-09-28;-112132
2021-09-27;"Trnavský kraj";80;2084;25;2109;NA;69457;105;2021-09-27;-112298
2021-09-26;"Trnavský kraj";2;1048;12;1060;NA;69457;14;2021-09-26;-112403
2021-09-25;"Trnavský kraj";61;1105;9;1114;NA;69457;70;2021-09-25;-112417
2021-09-24;"Trnavský kraj";41;2229;15;2244;NA;69457;56;2021-09-24;-112487
2021-09-23;"Trnavský kraj";89;1691;16;1707;NA;69457;105;2021-09-23;-112543
2021-09-22;"Trnavský kraj";119;1706;28;1734;NA;69457;147;2021-09-22;-112648
2021-09-21;"Trnavský kraj";108;1505;17;1522;NA;69457;125;2021-09-21;-112795
2021-09-20;"Trnavský kraj";50;1652;20;1672;NA;69457;70;2021-09-20;-112920
2021-09-19;"Trnavský kraj";2;924;8;932;NA;69457;10;2021-09-19;-112990
2021-09-18;"Trnavský kraj";100;982;6;988;NA;69457;106;2021-09-18;-113000
2021-09-17;"Trnavský kraj";77;1709;20;1729;NA;69457;97;2021-09-17;-113106
2021-09-16;"Trnavský kraj";105;1279;32;1311;NA;69457;137;2021-09-16;-113203
2021-09-15;"Trnavský kraj";59;841;5;846;NA;69457;64;2021-09-15;-113340
2021-09-14;"Trnavský kraj";38;1583;12;1595;NA;69457;50;2021-09-14;-113404
2021-09-13;"Trnavský kraj";56;1410;16;1426;NA;69457;72;2021-09-13;-113454
2021-09-12;"Trnavský kraj";0;653;1;654;NA;69457;1;2021-09-12;-113526
2021-09-11;"Trnavský kraj";37;971;10;981;NA;69457;47;2021-09-11;-113527
2021-09-10;"Trnavský kraj";43;1441;9;1450;NA;69457;52;2021-09-10;-113574
2021-09-09;"Trnavský kraj";42;954;13;967;NA;69457;55;2021-09-09;-113626
2021-09-08;"Trnavský kraj";65;802;15;817;NA;69457;80;2021-09-08;-113681
2021-09-07;"Trnavský kraj";29;844;5;849;NA;69457;34;2021-09-07;-113761
2021-09-06;"Trnavský kraj";18;1234;14;1248;NA;69457;32;2021-09-06;-113795
2021-09-05;"Trnavský kraj";2;580;4;584;NA;69457;6;2021-09-05;-113827
2021-09-04;"Trnavský kraj";17;868;6;874;NA;69457;23;2021-09-04;-113833
2021-09-03;"Trnavský kraj";14;1060;5;1065;NA;69457;19;2021-09-03;-113856
2021-09-02;"Trnavský kraj";30;830;10;840;NA;69457;40;2021-09-02;-113875
2021-09-01;"Trnavský kraj";6;409;4;413;NA;69457;10;2021-09-01;-113915
2021-08-31;"Trnavský kraj";13;884;3;887;NA;69457;16;2021-08-31;-113925
2021-08-30;"Trnavský kraj";7;904;1;905;NA;69457;8;2021-08-30;-113941
2021-08-29;"Trnavský kraj";8;427;1;428;NA;69457;9;2021-08-29;-113949
2021-08-28;"Trnavský kraj";17;694;2;696;NA;69457;19;2021-08-28;-113958
2021-08-27;"Trnavský kraj";1;1186;4;1190;NA;69457;5;2021-08-27;-113977
2021-08-26;"Trnavský kraj";8;713;3;716;NA;69457;11;2021-08-26;-113982
2021-08-25;"Trnavský kraj";11;683;6;689;NA;69457;17;2021-08-25;-113993
2021-08-24;"Trnavský kraj";7;801;1;802;NA;69457;8;2021-08-24;-114010
2021-08-23;"Trnavský kraj";4;844;1;845;NA;69457;5;2021-08-23;-114018
2021-08-22;"Trnavský kraj";0;474;0;474;NA;69457;0;2021-08-22;-114023
2021-08-21;"Trnavský kraj";8;703;0;703;NA;69457;8;2021-08-21;-114023
2021-08-20;"Trnavský kraj";4;1095;4;1099;NA;69457;8;2021-08-20;-114031
2021-08-19;"Trnavský kraj";10;881;3;884;NA;69457;13;2021-08-19;-114039
2021-08-18;"Trnavský kraj";6;789;2;791;NA;69457;8;2021-08-18;-114052
2021-08-17;"Trnavský kraj";7;524;4;528;NA;69457;11;2021-08-17;-114060
2021-08-16;"Trnavský kraj";9;966;3;969;NA;69457;12;2021-08-16;-114071
2021-08-15;"Trnavský kraj";0;556;1;557;NA;69457;1;2021-08-15;-114083
2021-08-14;"Trnavský kraj";10;801;3;804;NA;69457;13;2021-08-14;-114084
2021-08-13;"Trnavský kraj";5;1077;6;1083;NA;69457;11;2021-08-13;-114097
2021-08-12;"Trnavský kraj";3;666;3;669;NA;69457;6;2021-08-12;-114108
2021-08-11;"Trnavský kraj";7;576;2;578;NA;69457;9;2021-08-11;-114114
2021-08-10;"Trnavský kraj";3;757;3;760;NA;69457;6;2021-08-10;-114123
2021-08-09;"Trnavský kraj";12;808;0;808;NA;69457;12;2021-08-09;-114129
2021-08-08;"Trnavský kraj";1;545;0;545;NA;69457;1;2021-08-08;-114141
2021-08-07;"Trnavský kraj";9;724;0;724;NA;69457;9;2021-08-07;-114142
2021-08-06;"Trnavský kraj";3;988;0;988;NA;69457;3;2021-08-06;-114151
2021-08-05;"Trnavský kraj";2;662;1;663;NA;69457;3;2021-08-05;-114154
2021-08-04;"Trnavský kraj";1;891;1;892;NA;69457;2;2021-08-04;-114157
2021-08-03;"Trnavský kraj";13;645;0;645;NA;69457;13;2021-08-03;-114159
2021-08-02;"Trnavský kraj";2;725;1;726;NA;69457;3;2021-08-02;-114172
2021-08-01;"Trnavský kraj";0;565;2;567;NA;69457;2;2021-08-01;-114175
2021-07-31;"Trnavský kraj";3;886;0;886;NA;69457;3;2021-07-31;-114177
2021-07-30;"Trnavský kraj";3;1084;3;1087;NA;69457;6;2021-07-30;-114180
2021-07-29;"Trnavský kraj";1;775;0;775;NA;69457;1;2021-07-29;-114186
2021-07-28;"Trnavský kraj";5;794;1;795;NA;69457;6;2021-07-28;-114187
2021-07-27;"Trnavský kraj";7;623;2;625;NA;69457;9;2021-07-27;-114193
2021-07-26;"Trnavský kraj";2;857;2;859;NA;69457;4;2021-07-26;-114202
2021-07-25;"Trnavský kraj";0;707;0;707;NA;69457;0;2021-07-25;-114206
2021-07-24;"Trnavský kraj";4;828;2;830;NA;69457;6;2021-07-24;-114206
2021-07-23;"Trnavský kraj";3;1057;0;1057;NA;69457;3;2021-07-23;-114212
2021-07-22;"Trnavský kraj";0;671;2;673;NA;69457;2;2021-07-22;-114215
2021-07-21;"Trnavský kraj";2;660;2;662;NA;69457;4;2021-07-21;-114217
2021-07-20;"Trnavský kraj";2;593;0;593;NA;69457;2;2021-07-20;-114221
2021-07-19;"Trnavský kraj";9;886;0;886;NA;69457;9;2021-07-19;-114223
2021-07-18;"Trnavský kraj";0;600;2;602;NA;69457;2;2021-07-18;-114232
2021-07-17;"Trnavský kraj";8;796;0;796;NA;69457;8;2021-07-17;-114234
2021-07-16;"Trnavský kraj";11;963;0;963;NA;69457;11;2021-07-16;-114242
2021-07-15;"Trnavský kraj";4;832;1;833;NA;69457;5;2021-07-15;-114253
2021-07-14;"Trnavský kraj";1;699;1;700;NA;69457;2;2021-07-14;-114258
2021-07-13;"Trnavský kraj";1;693;1;694;NA;69457;2;2021-07-13;-114260
2021-07-12;"Trnavský kraj";4;959;0;959;NA;69457;4;2021-07-12;-114262
2021-07-11;"Trnavský kraj";0;692;0;692;NA;69457;0;2021-07-11;-114266
2021-07-10;"Trnavský kraj";1;803;0;803;NA;69457;1;2021-07-10;-114266
2021-07-09;"Trnavský kraj";3;1262;3;1265;NA;69457;6;2021-07-09;-114267
2021-07-08;"Trnavský kraj";4;755;0;755;NA;69457;4;2021-07-08;-114273
2021-07-07;"Trnavský kraj";9;924;2;926;NA;69457;11;2021-07-07;-114277
2021-07-06;"Trnavský kraj";2;1401;1;1402;NA;69457;3;2021-07-06;-114288
2021-07-05;"Trnavský kraj";1;503;2;505;NA;69457;3;2021-07-05;-114291
2021-07-04;"Trnavský kraj";0;1129;3;1132;NA;69457;3;2021-07-04;-114294
2021-07-03;"Trnavský kraj";4;815;0;815;NA;69457;4;2021-07-03;-114297
2021-07-02;"Trnavský kraj";2;1137;2;1139;NA;69457;4;2021-07-02;-114301
2021-07-01;"Trnavský kraj";4;487;0;487;NA;69457;4;2021-07-01;-114305
2021-06-30;"Trnavský kraj";0;5135;1;5136;NA;69457;1;2021-06-30;-114309
2021-06-29;"Trnavský kraj";4;2563;1;2564;NA;69457;5;2021-06-29;-114310
2021-06-28;"Trnavský kraj";2;2600;1;2601;NA;69457;3;2021-06-28;-114315
2021-06-27;"Trnavský kraj";0;3213;0;3213;NA;69457;0;2021-06-27;-114318
2021-06-26;"Trnavský kraj";3;3871;1;3872;NA;69457;4;2021-06-26;-114318
2021-06-25;"Trnavský kraj";2;4374;3;4377;NA;69457;5;2021-06-25;-114322
2021-06-24;"Trnavský kraj";4;2520;3;2523;NA;69457;7;2021-06-24;-114327
2021-06-23;"Trnavský kraj";4;2842;2;2844;NA;69457;6;2021-06-23;-114334
2021-06-22;"Trnavský kraj";2;2996;1;2997;NA;69457;3;2021-06-22;-114340
2021-06-21;"Trnavský kraj";6;3114;5;3119;NA;69457;11;2021-06-21;-114343
2021-06-20;"Trnavský kraj";0;3952;1;3953;NA;69457;1;2021-06-20;-114354
2021-06-19;"Trnavský kraj";3;4735;2;4737;NA;69457;5;2021-06-19;-114355
2021-06-18;"Trnavský kraj";5;6125;4;6129;NA;69457;9;2021-06-18;-114360
2021-06-17;"Trnavský kraj";3;3340;0;3340;NA;69457;3;2021-06-17;-114369
2021-06-16;"Trnavský kraj";6;2926;3;2929;NA;69457;9;2021-06-16;-114372
2021-06-15;"Trnavský kraj";8;3234;3;3237;NA;69457;11;2021-06-15;-114381
2021-06-14;"Trnavský kraj";2;3829;1;3830;NA;69457;3;2021-06-14;-114392
2021-06-13;"Trnavský kraj";0;5001;8;5009;NA;69457;8;2021-06-13;-114395
2021-06-12;"Trnavský kraj";11;5807;2;5809;NA;69457;13;2021-06-12;-114403
2021-06-11;"Trnavský kraj";17;5850;4;5854;NA;69457;21;2021-06-11;-114416
2021-06-10;"Trnavský kraj";14;3476;1;3477;NA;69457;15;2021-06-10;-114437
2021-06-09;"Trnavský kraj";10;3685;1;3686;NA;69457;11;2021-06-09;-114452
2021-06-08;"Trnavský kraj";8;3344;4;3348;NA;69457;12;2021-06-08;-114463
2021-06-07;"Trnavský kraj";12;4498;8;4506;NA;69457;20;2021-06-07;-114475
2021-06-06;"Trnavský kraj";0;5517;2;5519;NA;69457;2;2021-06-06;-114495
2021-06-05;"Trnavský kraj";20;6905;8;6913;NA;69457;28;2021-06-05;-114497
2021-06-04;"Trnavský kraj";9;6735;10;6745;NA;69457;19;2021-06-04;-114525
2021-06-03;"Trnavský kraj";14;4361;11;4372;NA;69457;25;2021-06-03;-114544
2021-06-02;"Trnavský kraj";4;4148;11;4159;NA;69457;15;2021-06-02;-114569
2021-06-01;"Trnavský kraj";18;3662;5;3667;NA;69457;23;2021-06-01;-114584
2021-05-31;"Trnavský kraj";14;5515;16;5531;NA;69457;30;2021-05-31;-114607
2021-05-30;"Trnavský kraj";0;6473;7;6480;NA;69457;7;2021-05-30;-114637
2021-05-29;"Trnavský kraj";11;8964;4;8968;NA;69457;15;2021-05-29;-114644
2021-05-28;"Trnavský kraj";14;7160;11;7171;NA;69457;25;2021-05-28;-114659
2021-05-27;"Trnavský kraj";22;4753;8;4761;NA;69457;30;2021-05-27;-114684
2021-05-26;"Trnavský kraj";6;4870;8;4878;NA;69457;14;2021-05-26;-114714
2021-05-25;"Trnavský kraj";19;5026;27;5053;NA;69457;46;2021-05-25;-114728
2021-05-24;"Trnavský kraj";15;6520;22;6542;NA;69457;37;2021-05-24;-114774
2021-05-23;"Trnavský kraj";0;7920;8;7928;NA;69457;8;2021-05-23;-114811
2021-05-22;"Trnavský kraj";13;13381;21;13402;NA;69457;34;2021-05-22;-114819
2021-05-21;"Trnavský kraj";16;8525;19;8544;NA;69457;35;2021-05-21;-114853
2021-05-20;"Trnavský kraj";15;5511;11;5522;NA;69457;26;2021-05-20;-114888
2021-05-19;"Trnavský kraj";18;5431;13;5444;NA;69457;31;2021-05-19;-114914
2021-05-18;"Trnavský kraj";26;5768;15;5783;NA;69457;41;2021-05-18;-114945
2021-05-17;"Trnavský kraj";17;6262;24;6286;NA;69457;41;2021-05-17;-114986
2021-05-16;"Trnavský kraj";10;9984;8;9992;NA;69457;18;2021-05-16;-115027
2021-05-15;"Trnavský kraj";11;18525;14;18539;NA;69457;25;2021-05-15;-115045
2021-05-14;"Trnavský kraj";34;10279;21;10300;NA;69457;55;2021-05-14;-115070
2021-05-13;"Trnavský kraj";26;6913;12;6925;NA;69457;38;2021-05-13;-115125
2021-05-12;"Trnavský kraj";34;6621;26;6647;NA;69457;60;2021-05-12;-115163
2021-05-11;"Trnavský kraj";32;6393;13;6406;NA;69457;45;2021-05-11;-115223
2021-05-10;"Trnavský kraj";58;9139;24;9163;NA;69457;82;2021-05-10;-115268
2021-05-09;"Trnavský kraj";21;12570;12;12582;NA;69457;33;2021-05-09;-115350
2021-05-08;"Trnavský kraj";4;23028;22;23050;NA;69457;26;2021-05-08;-115383
2021-05-07;"Trnavský kraj";26;15465;30;15495;NA;69457;56;2021-05-07;-115409
2021-05-06;"Trnavský kraj";22;8407;22;8429;NA;69457;44;2021-05-06;-115465
2021-05-05;"Trnavský kraj";34;6273;22;6295;NA;69457;56;2021-05-05;-115509
2021-05-04;"Trnavský kraj";51;8538;17;8555;NA;69457;68;2021-05-04;-115565
2021-05-03;"Trnavský kraj";20;8957;22;8979;NA;69457;42;2021-05-03;-115633
2021-05-02;"Trnavský kraj";0;25657;29;25686;NA;69457;29;2021-05-02;-115675
2021-05-01;"Trnavský kraj";30;81353;64;81417;NA;69457;94;2021-05-01;-115704
2021-04-30;"Trnavský kraj";45;26846;35;26881;NA;69457;80;2021-04-30;-115798
2021-04-29;"Trnavský kraj";25;20323;28;20351;NA;69457;53;2021-04-29;-115878
2021-04-28;"Trnavský kraj";46;8896;28;8924;NA;69457;74;2021-04-28;-115931
2021-04-27;"Trnavský kraj";54;8756;37;8793;NA;69457;91;2021-04-27;-116005
2021-04-26;"Trnavský kraj";53;16116;42;16158;NA;69457;95;2021-04-26;-116096
2021-04-25;"Trnavský kraj";0;30183;24;30207;NA;69457;24;2021-04-25;-116191
2021-04-24;"Trnavský kraj";46;126077;84;126161;NA;69457;130;2021-04-24;-116215
2021-04-23;"Trnavský kraj";71;25741;53;25794;NA;69457;124;2021-04-23;-116345
2021-04-22;"Trnavský kraj";40;10904;25;10929;NA;69457;65;2021-04-22;-116469
2021-04-21;"Trnavský kraj";60;10748;45;10793;NA;69457;105;2021-04-21;-116534
2021-04-20;"Trnavský kraj";57;13504;28;13532;NA;69457;85;2021-04-20;-116639
2021-04-19;"Trnavský kraj";46;14603;18;14621;NA;69457;64;2021-04-19;-116724
2021-04-18;"Trnavský kraj";7;40843;43;40886;NA;69457;50;2021-04-18;-116788
2021-04-17;"Trnavský kraj";58;118102;89;118191;NA;69457;147;2021-04-17;-116838
2021-04-16;"Trnavský kraj";67;25962;48;26010;NA;69457;115;2021-04-16;-116985
2021-04-15;"Trnavský kraj";65;11373;36;11409;NA;69457;101;2021-04-15;-117100
2021-04-14;"Trnavský kraj";78;18442;53;18495;NA;69457;131;2021-04-14;-117201
2021-04-13;"Trnavský kraj";126;9871;44;9915;NA;69457;170;2021-04-13;-117332
2021-04-12;"Trnavský kraj";40;15577;40;15617;NA;69457;80;2021-04-12;-117502
2021-04-11;"Trnavský kraj";3;44420;44;44464;NA;69457;47;2021-04-11;-117582
2021-04-10;"Trnavský kraj";60;123822;107;123929;NA;69457;167;2021-04-10;-117629
2021-04-09;"Trnavský kraj";95;26191;34;26225;NA;69457;129;2021-04-09;-117796
2021-04-08;"Trnavský kraj";85;10913;54;10967;NA;69457;139;2021-04-08;-117925
2021-04-07;"Trnavský kraj";131;15979;81;16060;NA;69457;212;2021-04-07;-118064
2021-04-06;"Trnavský kraj";92;20586;90;20676;NA;69457;182;2021-04-06;-118276
2021-04-05;"Trnavský kraj";91;7542;17;7559;NA;69457;108;2021-04-05;-118458
2021-04-04;"Trnavský kraj";9;28831;49;28880;NA;69457;58;2021-04-04;-118566
2021-04-03;"Trnavský kraj";29;144452;186;144638;NA;69457;215;2021-04-03;-118624
2021-04-02;"Trnavský kraj";91;17538;33;17571;NA;69457;124;2021-04-02;-118839
2021-04-01;"Trnavský kraj";118;22279;71;22350;NA;69457;189;2021-04-01;-118963
2021-03-31;"Trnavský kraj";140;15828;82;15910;NA;69457;222;2021-03-31;-119152
2021-03-30;"Trnavský kraj";182;10482;79;10561;NA;69457;261;2021-03-30;-119374
2021-03-29;"Trnavský kraj";126;19255;122;19377;NA;69457;248;2021-03-29;-119635
2021-03-28;"Trnavský kraj";26;50664;134;50798;NA;69457;160;2021-03-28;-119883
2021-03-27;"Trnavský kraj";64;130217;246;130463;NA;69457;310;2021-03-27;-120043
2021-03-26;"Trnavský kraj";139;30217;130;30347;NA;69457;269;2021-03-26;-120353
2021-03-25;"Trnavský kraj";135;14212;80;14292;NA;69457;215;2021-03-25;-120622
2021-03-24;"Trnavský kraj";159;10521;89;10610;NA;69457;248;2021-03-24;-120837
2021-03-23;"Trnavský kraj";221;12735;104;12839;NA;69457;325;2021-03-23;-121085
2021-03-22;"Trnavský kraj";103;17118;110;17228;NA;69457;213;2021-03-22;-121410
2021-03-21;"Trnavský kraj";31;49119;150;49269;NA;69457;181;2021-03-21;-121623
2021-03-20;"Trnavský kraj";112;136963;317;137280;NA;69457;429;2021-03-20;-121804
2021-03-19;"Trnavský kraj";174;29071;137;29208;NA;69457;311;2021-03-19;-122233
2021-03-18;"Trnavský kraj";158;12217;136;12353;NA;69457;294;2021-03-18;-122544
2021-03-17;"Trnavský kraj";245;10434;103;10537;NA;69457;348;2021-03-17;-122838
2021-03-16;"Trnavský kraj";311;12811;135;12946;NA;69457;446;2021-03-16;-123186
2021-03-15;"Trnavský kraj";127;18271;146;18417;NA;69457;273;2021-03-15;-123632
2021-03-14;"Trnavský kraj";14;47608;164;47772;NA;69457;178;2021-03-14;-123905
2021-03-13;"Trnavský kraj";155;139224;409;139633;NA;69457;564;2021-03-13;-124083
2021-03-12;"Trnavský kraj";201;28566;181;28747;NA;69457;382;2021-03-12;-124647
2021-03-11;"Trnavský kraj";204;13301;140;13441;NA;69457;344;2021-03-11;-125029
2021-03-10;"Trnavský kraj";242;10583;135;10718;NA;69457;377;2021-03-10;-125373
2021-03-09;"Trnavský kraj";442;12824;155;12979;NA;69457;597;2021-03-09;-125750
2021-03-08;"Trnavský kraj";182;21812;166;21978;NA;69457;348;2021-03-08;-126347
2021-03-07;"Trnavský kraj";30;45463;227;45690;NA;69457;257;2021-03-07;-126695
2021-03-06;"Trnavský kraj";154;135784;531;136315;NA;69457;685;2021-03-06;-126952
2021-03-05;"Trnavský kraj";299;27959;239;28198;NA;69457;538;2021-03-05;-127637
2021-03-04;"Trnavský kraj";238;14505;176;14681;NA;69457;414;2021-03-04;-128175
2021-03-03;"Trnavský kraj";413;11583;246;11829;NA;69457;659;2021-03-03;-128589
2021-03-02;"Trnavský kraj";477;12367;191;12558;NA;69457;668;2021-03-02;-129248
2021-03-01;"Trnavský kraj";189;18586;234;18820;NA;69457;423;2021-03-01;-129916
2021-02-28;"Trnavský kraj";87;47709;321;48030;NA;69457;408;2021-02-28;-130339
2021-02-27;"Trnavský kraj";264;140224;800;141024;NA;69457;1064;2021-02-27;-130747
2021-02-26;"Trnavský kraj";362;26637;284;26921;NA;69457;646;2021-02-26;-131811
2021-02-25;"Trnavský kraj";433;10490;227;10717;NA;69457;660;2021-02-25;-132457
2021-02-24;"Trnavský kraj";407;9113;290;9403;NA;69457;697;2021-02-24;-133117
2021-02-23;"Trnavský kraj";469;11322;284;11606;NA;69457;753;2021-02-23;-133814
2021-02-22;"Trnavský kraj";206;19901;330;20231;NA;69457;536;2021-02-22;-134567
2021-02-21;"Trnavský kraj";38;48221;329;48550;NA;69457;367;2021-02-21;-135103
2021-02-20;"Trnavský kraj";273;135835;859;136694;NA;69457;1132;2021-02-20;-135470
2021-02-19;"Trnavský kraj";335;26382;366;26748;NA;69457;701;2021-02-19;-136602
2021-02-18;"Trnavský kraj";344;11264;348;11612;NA;69457;692;2021-02-18;-137303
2021-02-17;"Trnavský kraj";431;8783;416;9199;NA;69457;847;2021-02-17;-137995
2021-02-16;"Trnavský kraj";426;11236;294;11530;NA;69457;720;2021-02-16;-138842
2021-02-15;"Trnavský kraj";146;18276;326;18602;NA;69457;472;2021-02-15;-139562
2021-02-14;"Trnavský kraj";51;57642;495;58137;NA;69457;546;2021-02-14;-140034
2021-02-13;"Trnavský kraj";218;137051;994;138045;NA;69457;1212;2021-02-13;-140580
2021-02-12;"Trnavský kraj";300;24090;352;24442;NA;69457;652;2021-02-12;-141792
2021-02-11;"Trnavský kraj";422;9831;349;10180;NA;69457;771;2021-02-11;-142444
2021-02-10;"Trnavský kraj";511;9194;342;9536;NA;69457;853;2021-02-10;-143215
2021-02-09;"Trnavský kraj";544;12755;369;13124;NA;69457;913;2021-02-09;-144068
2021-02-08;"Trnavský kraj";220;33414;497;33911;NA;69457;717;2021-02-08;-144981
2021-02-07;"Trnavský kraj";140;69694;628;70322;NA;69457;768;2021-02-07;-145698
2021-02-06;"Trnavský kraj";348;112687;1482;114169;NA;69457;1830;2021-02-06;-146466
2021-02-05;"Trnavský kraj";377;16063;373;16436;NA;69457;750;2021-02-05;-148296
2021-02-04;"Trnavský kraj";456;7317;456;7773;NA;69457;912;2021-02-04;-149046
2021-02-03;"Trnavský kraj";472;6583;434;7017;NA;69457;906;2021-02-03;-149958
2021-02-02;"Trnavský kraj";446;14243;424;14667;NA;69457;870;2021-02-02;-150864
2021-02-01;"Trnavský kraj";198;38882;679;39561;NA;69457;877;2021-02-01;-151734
2021-01-31;"Trnavský kraj";19;64707;822;65529;NA;69457;841;2021-01-31;-152611
2021-01-30;"Trnavský kraj";323;111483;1288;112771;NA;69457;1611;2021-01-30;-153452
2021-01-29;"Trnavský kraj";421;9689;290;9979;NA;69457;711;2021-01-29;-155063
2021-01-28;"Trnavský kraj";389;5817;289;6106;NA;69457;678;2021-01-28;-155774
2021-01-27;"Trnavský kraj";433;5554;225;5779;NA;69457;658;2021-01-27;-156452
2021-01-26;"Trnavský kraj";565;25411;636;26047;NA;69457;1201;2021-01-26;-157110
2021-01-25;"Trnavský kraj";210;41805;620;42425;NA;69457;830;2021-01-25;-158311
2021-01-24;"Trnavský kraj";91;66399;779;67178;NA;69457;870;2021-01-24;-159141
2021-01-23;"Trnavský kraj";372;113375;1319;114694;NA;69457;1691;2021-01-23;-160011
2021-01-22;"Trnavský kraj";217;32755;505;33260;NA;69457;722;2021-01-22;-161702
2021-01-21;"Trnavský kraj";311;13913;377;14290;NA;69457;688;2021-01-21;-162424
2021-01-20;"Trnavský kraj";503;8685;283;8968;NA;69457;786;2021-01-20;-163112
2021-01-19;"Trnavský kraj";415;7013;347;7360;NA;69457;762;2021-01-19;-163898
2021-01-18;"Trnavský kraj";247;6690;513;7203;NA;69457;760;2021-01-18;-164660
2021-01-17;"Trnavský kraj";128;854;215;1069;NA;69457;343;2021-01-17;-165420
2021-01-16;"Trnavský kraj";103;898;24;922;NA;69457;127;2021-01-16;-165763
2021-01-15;"Trnavský kraj";278;5467;336;5803;NA;69457;614;2021-01-15;-165890
2021-01-14;"Trnavský kraj";452;4001;338;4339;NA;69457;790;2021-01-14;-166504
2021-01-13;"Trnavský kraj";457;4751;378;5129;NA;69457;835;2021-01-13;-167294
2021-01-12;"Trnavský kraj";469;6860;470;7330;NA;69457;939;2021-01-12;-168129
2021-01-11;"Trnavský kraj";370;4587;360;4947;NA;69457;730;2021-01-11;-169068
2021-01-10;"Trnavský kraj";71;13;0;13;NA;69457;71;2021-01-10;-169798
2021-01-09;"Trnavský kraj";417;1775;100;1875;NA;69457;517;2021-01-09;-169869
2021-01-08;"Trnavský kraj";381;6016;506;6522;NA;69457;887;2021-01-08;-170386
2021-01-07;"Trnavský kraj";501;3545;329;3874;NA;69457;830;2021-01-07;-171273
2021-01-06;"Trnavský kraj";179;758;132;890;NA;69457;311;2021-01-06;-172103
2021-01-05;"Trnavský kraj";611;5165;561;5726;NA;69457;1172;2021-01-05;-172414
2021-01-04;"Trnavský kraj";302;5556;709;6265;NA;69457;1011;2021-01-04;-173586
2021-01-03;"Trnavský kraj";60;53;7;60;NA;69457;67;2021-01-03;-174597
2021-01-02;"Trnavský kraj";282;417;32;449;NA;69457;314;2021-01-02;-174664
2021-01-01;"Trnavský kraj";143;455;76;531;NA;69457;219;2021-01-01;-174978
2020-12-31;"Trnavský kraj";498;8325;820;9145;NA;69457;1318;2020-12-31;-175197
2020-12-30;"Trnavský kraj";785;5318;612;5930;NA;69457;1397;2020-12-30;-176515
2020-12-29;"Trnavský kraj";322;4913;565;5478;NA;69457;887;2020-12-29;-177912
2020-12-28;"Trnavský kraj";213;4900;552;5452;NA;69457;765;2020-12-28;-178799
2020-12-27;"Trnavský kraj";27;20;4;24;NA;69457;31;2020-12-27;-179564
2020-12-26;"Trnavský kraj";148;44;1;45;NA;69457;149;2020-12-26;-179595
2020-12-25;"Trnavský kraj";65;49;5;54;NA;69457;70;2020-12-25;-179744
2020-12-24;"Trnavský kraj";333;1359;117;1476;NA;69457;450;2020-12-24;-179814
2020-12-23;"Trnavský kraj";210;6672;414;7086;NA;69457;624;2020-12-23;-180264
2020-12-22;"Trnavský kraj";311;5427;455;5882;NA;69457;766;2020-12-22;-180888
2020-12-21;"Trnavský kraj";328;4092;350;4442;NA;69457;678;2020-12-21;-181654
2020-12-20;"Trnavský kraj";134;133;12;145;NA;69457;146;2020-12-20;-182332
2020-12-19;"Trnavský kraj";201;1407;103;1510;NA;69457;304;2020-12-19;-182478
2020-12-18;"Trnavský kraj";341;4432;334;4766;NA;69457;675;2020-12-18;-182782
2020-12-17;"Trnavský kraj";375;4880;414;5294;NA;69457;789;2020-12-17;-183457
2020-12-16;"Trnavský kraj";312;4945;383;5328;NA;69457;695;2020-12-16;-184246
2020-12-15;"Trnavský kraj";492;6240;598;6838;NA;69457;1090;2020-12-15;-184941
2020-12-14;"Trnavský kraj";161;3505;292;3797;NA;69457;453;2020-12-14;-186031
2020-12-13;"Trnavský kraj";7;7;0;7;NA;69457;7;2020-12-13;-186484
2020-12-12;"Trnavský kraj";254;1456;114;1570;NA;69457;368;2020-12-12;-186491
2020-12-11;"Trnavský kraj";384;4289;241;4530;NA;69457;625;2020-12-11;-186859
2020-12-10;"Trnavský kraj";183;5197;320;5517;NA;69457;503;2020-12-10;-187484
2020-12-09;"Trnavský kraj";521;4199;317;4516;NA;69457;838;2020-12-09;-187987
2020-12-08;"Trnavský kraj";281;4090;304;4394;NA;69457;585;2020-12-08;-188825
2020-12-07;"Trnavský kraj";178;2895;199;3094;NA;69457;377;2020-12-07;-189410
2020-12-06;"Trnavský kraj";46;0;0;0;NA;69457;46;2020-12-06;-189787
2020-12-05;"Trnavský kraj";129;2218;41;2259;NA;69457;170;2020-12-05;-189833
2020-12-04;"Trnavský kraj";242;3948;158;4106;NA;69457;400;2020-12-04;-190003
2020-12-03;"Trnavský kraj";248;2770;190;2960;NA;69457;438;2020-12-03;-190403
2020-12-02;"Trnavský kraj";284;4516;176;4692;NA;69457;460;2020-12-02;-190841
2020-12-01;"Trnavský kraj";253;3190;205;3395;NA;69457;458;2020-12-01;-191301
2020-11-30;"Trnavský kraj";200;7360;186;7546;NA;69457;386;2020-11-30;-191759
2020-11-29;"Trnavský kraj";17;738;36;774;NA;69457;53;2020-11-29;-192145
2020-11-28;"Trnavský kraj";83;1453;77;1530;NA;69457;160;2020-11-28;-192198
2020-11-27;"Trnavský kraj";148;1779;85;1864;NA;69457;233;2020-11-27;-192358
2020-11-26;"Trnavský kraj";234;1123;68;1191;NA;69457;302;2020-11-26;-192591
2020-11-25;"Trnavský kraj";232;1168;74;1242;NA;69457;306;2020-11-25;-192893
2020-11-24;"Trnavský kraj";295;1909;96;2005;NA;69457;391;2020-11-24;-193199
2020-11-23;"Trnavský kraj";242;7393;129;7522;NA;69457;371;2020-11-23;-193590
2020-11-22;"Trnavský kraj";10;82;9;91;NA;69457;19;2020-11-22;-193961
2020-11-21;"Trnavský kraj";129;1354;36;1390;NA;69457;165;2020-11-21;-193980
2020-11-20;"Trnavský kraj";246;1154;64;1218;NA;69457;310;2020-11-20;-194145
2020-11-19;"Trnavský kraj";157;823;64;887;NA;69457;221;2020-11-19;-194455
2020-11-18;"Trnavský kraj";235;822;82;904;NA;69457;317;2020-11-18;-194676
2020-11-17;"Trnavský kraj";129;705;74;779;NA;69457;203;2020-11-17;-194993
2020-11-16;"Trnavský kraj";187;732;32;764;NA;69457;219;2020-11-16;-195196
2020-11-15;"Trnavský kraj";23;73;4;77;NA;69457;27;2020-11-15;-195415
2020-11-14;"Trnavský kraj";86;397;12;409;NA;69457;98;2020-11-14;-195442
2020-11-13;"Trnavský kraj";219;1312;21;1333;NA;69457;240;2020-11-13;-195540
2020-11-12;"Trnavský kraj";162;420;18;438;NA;69457;180;2020-11-12;-195780
2020-11-11;"Trnavský kraj";257;392;15;407;NA;69457;272;2020-11-11;-195960
2020-11-10;"Trnavský kraj";189;889;30;919;NA;69457;219;2020-11-10;-196232
2020-11-09;"Trnavský kraj";196;369;23;392;NA;69457;219;2020-11-09;-196451
2020-11-08;"Trnavský kraj";55;400;4;404;NA;69457;59;2020-11-08;-196670
2020-11-07;"Trnavský kraj";207;6070;74;6144;NA;69457;281;2020-11-07;-196729
2020-11-06;"Trnavský kraj";260;1531;19;1550;NA;69457;279;2020-11-06;-197010
2020-11-05;"Trnavský kraj";150;220;27;247;NA;69457;177;2020-11-05;-197289
2020-11-04;"Trnavský kraj";188;212;10;222;NA;69457;198;2020-11-04;-197466
2020-11-03;"Trnavský kraj";317;127;8;135;NA;69457;325;2020-11-03;-197664
2020-11-02;"Trnavský kraj";281;1728;31;1759;NA;69457;312;2020-11-02;-197989
2020-11-01;"Trnavský kraj";87;494;27;521;NA;69457;114;2020-11-01;-198301
2020-10-31;"Trnavský kraj";259;5024;41;5065;NA;69457;300;2020-10-31;-198415
2020-10-30;"Trnavský kraj";198;3784;27;3811;NA;69457;225;2020-10-30;-198715
2020-10-29;"Trnavský kraj";273;1461;16;1477;NA;69457;289;2020-10-29;-198940
2020-10-28;"Trnavský kraj";319;117;16;133;NA;69457;335;2020-10-28;-199229
2020-10-27;"Trnavský kraj";199;461;36;497;NA;69457;235;2020-10-27;-199564
2020-10-26;"Trnavský kraj";153;29;2;31;NA;69457;155;2020-10-26;-199799
2020-10-25;"Trnavský kraj";95;19;1;20;NA;69457;96;2020-10-25;-199954
2020-10-24;"Trnavský kraj";158;109;2;111;NA;69457;160;2020-10-24;-200050
2020-10-23;"Trnavský kraj";201;89;4;93;NA;69457;205;2020-10-23;-200210
2020-10-22;"Trnavský kraj";195;55;2;57;NA;69457;197;2020-10-22;-200415
2020-10-21;"Trnavský kraj";134;73;3;76;NA;69457;137;2020-10-21;-200612
2020-10-20;"Trnavský kraj";202;82;3;85;NA;69457;205;2020-10-20;-200749
2020-10-19;"Trnavský kraj";67;55;0;55;NA;69457;67;2020-10-19;-200954
2020-10-18;"Trnavský kraj";84;0;0;0;NA;69457;84;2020-10-18;-201021
2020-10-17;"Trnavský kraj";123;0;0;0;NA;69457;123;2020-10-17;-201105
2020-10-16;"Trnavský kraj";86;45;2;47;NA;69457;88;2020-10-16;-201228
2020-10-15;"Trnavský kraj";155;66;2;68;NA;69457;157;2020-10-15;-201316
2020-10-14;"Trnavský kraj";236;468;3;471;NA;69457;239;2020-10-14;-201473
2020-10-13;"Trnavský kraj";138;16;2;18;NA;69457;140;2020-10-13;-201712
2020-10-12;"Trnavský kraj";33;41;1;42;NA;69457;34;2020-10-12;-201852
2020-10-11;"Trnavský kraj";31;0;0;0;NA;69457;31;2020-10-11;-201886
2020-10-10;"Trnavský kraj";128;0;0;0;NA;69457;128;2020-10-10;-201917
2020-10-09;"Trnavský kraj";156;0;0;0;NA;69457;156;2020-10-09;-202045
2020-10-08;"Trnavský kraj";153;0;0;0;NA;69457;153;2020-10-08;-202201
2020-10-07;"Trnavský kraj";80;0;0;0;NA;69457;80;2020-10-07;-202354
2020-10-06;"Trnavský kraj";112;0;0;0;NA;69457;112;2020-10-06;-202434
2020-10-05;"Trnavský kraj";33;0;0;0;NA;69457;33;2020-10-05;-202546
2020-10-04;"Trnavský kraj";44;0;0;0;NA;69457;44;2020-10-04;-202579
2020-10-03;"Trnavský kraj";60;0;0;0;NA;69457;60;2020-10-03;-202623
2020-10-02;"Trnavský kraj";41;0;0;0;NA;69457;41;2020-10-02;-202683
2020-10-01;"Trnavský kraj";53;0;0;0;NA;69457;53;2020-10-01;-202724
2020-09-30;"Trnavský kraj";91;0;0;0;NA;69457;91;2020-09-30;-202777
2020-09-29;"Trnavský kraj";40;0;0;0;NA;69457;40;2020-09-29;-202868
2020-09-28;"Trnavský kraj";69;0;0;0;NA;69457;69;2020-09-28;-202908
2020-09-27;"Trnavský kraj";30;0;0;0;NA;69457;30;2020-09-27;-202977
2020-09-26;"Trnavský kraj";46;0;0;0;NA;69457;46;2020-09-26;-203007
2020-09-25;"Trnavský kraj";32;0;0;0;NA;69457;32;2020-09-25;-203053
2020-09-24;"Trnavský kraj";42;0;0;0;NA;69457;42;2020-09-24;-203085
2020-09-23;"Trnavský kraj";43;0;0;0;NA;69457;43;2020-09-23;-203127
2020-09-22;"Trnavský kraj";55;0;0;0;NA;69457;55;2020-09-22;-203170
2020-09-21;"Trnavský kraj";41;0;0;0;NA;69457;41;2020-09-21;-203225
2020-09-20;"Trnavský kraj";17;0;0;0;NA;69457;17;2020-09-20;-203266
2020-09-19;"Trnavský kraj";4;0;0;0;NA;69457;4;2020-09-19;-203283
2020-09-18;"Trnavský kraj";33;0;0;0;NA;69457;33;2020-09-18;-203287
2020-09-17;"Trnavský kraj";42;0;0;0;NA;69457;42;2020-09-17;-203320
2020-09-16;"Trnavský kraj";49;0;0;0;NA;69457;49;2020-09-16;-203362
2020-09-15;"Trnavský kraj";5;0;0;0;NA;69457;5;2020-09-15;-203411
2020-09-14;"Trnavský kraj";26;0;0;0;NA;69457;26;2020-09-14;-203416
2020-09-13;"Trnavský kraj";9;0;0;0;NA;69457;9;2020-09-13;-203442
2020-09-12;"Trnavský kraj";12;0;0;0;NA;69457;12;2020-09-12;-203451
2020-09-11;"Trnavský kraj";16;0;0;0;NA;69457;16;2020-09-11;-203463
2020-09-10;"Trnavský kraj";32;0;0;0;NA;69457;32;2020-09-10;-203479
2020-09-09;"Trnavský kraj";14;0;0;0;NA;69457;14;2020-09-09;-203511
2020-09-08;"Trnavský kraj";11;0;0;0;NA;69457;11;2020-09-08;-203525
2020-09-07;"Trnavský kraj";7;0;0;0;NA;69457;7;2020-09-07;-203536
2020-09-06;"Trnavský kraj";5;0;0;0;NA;69457;5;2020-09-06;-203543
2020-09-05;"Trnavský kraj";7;0;0;0;NA;69457;7;2020-09-05;-203548
2020-09-04;"Trnavský kraj";16;0;0;0;NA;69457;16;2020-09-04;-203555
2020-09-03;"Trnavský kraj";8;0;0;0;NA;69457;8;2020-09-03;-203571
2020-09-02;"Trnavský kraj";7;0;0;0;NA;69457;7;2020-09-02;-203579
2020-09-01;"Trnavský kraj";1;0;0;0;NA;69457;1;2020-09-01;-203586
2020-08-31;"Trnavský kraj";6;0;0;0;NA;69457;6;2020-08-31;-203587
2020-08-30;"Trnavský kraj";1;0;0;0;NA;69457;1;2020-08-30;-203593
2020-08-29;"Trnavský kraj";3;0;0;0;NA;69457;3;2020-08-29;-203594
2020-08-28;"Trnavský kraj";14;0;0;0;NA;69457;14;2020-08-28;-203597
2020-08-27;"Trnavský kraj";6;0;0;0;NA;69457;6;2020-08-27;-203611
2020-08-26;"Trnavský kraj";4;0;0;0;NA;69457;4;2020-08-26;-203617
2020-08-25;"Trnavský kraj";7;0;0;0;NA;69457;7;2020-08-25;-203621
2020-08-24;"Trnavský kraj";1;0;0;0;NA;69457;1;2020-08-24;-203628
2020-08-23;"Trnavský kraj";6;0;0;0;NA;69457;6;2020-08-23;-203629
2020-08-22;"Trnavský kraj";3;0;0;0;NA;69457;3;2020-08-22;-203635
2020-08-21;"Trnavský kraj";4;0;0;0;NA;69457;4;2020-08-21;-203638
2020-08-20;"Trnavský kraj";23;0;0;0;NA;69457;23;2020-08-20;-203642
2020-08-19;"Trnavský kraj";13;0;0;0;NA;69457;13;2020-08-19;-203665
2020-08-18;"Trnavský kraj";20;0;0;0;NA;69457;20;2020-08-18;-203678
2020-08-17;"Trnavský kraj";3;0;0;0;NA;69457;3;2020-08-17;-203698
2020-08-16;"Trnavský kraj";0;0;0;0;NA;69457;0;2020-08-16;-203701
2020-08-15;"Trnavský kraj";7;0;0;0;NA;69457;7;2020-08-15;-203701
2020-08-14;"Trnavský kraj";6;0;0;0;NA;69457;6;2020-08-14;-203708
2020-08-13;"Trnavský kraj";10;0;0;0;NA;69457;10;2020-08-13;-203714
2020-08-12;"Trnavský kraj";2;0;0;0;NA;69457;2;2020-08-12;-203724
2020-08-11;"Trnavský kraj";30;0;0;0;NA;69457;30;2020-08-11;-203726
2020-08-10;"Trnavský kraj";0;0;0;0;NA;69457;0;2020-08-10;-203756
2020-08-09;"Trnavský kraj";0;0;0;0;NA;69457;0;2020-08-09;-203756
2020-08-08;"Trnavský kraj";13;0;0;0;NA;69457;13;2020-08-08;-203756
2020-08-07;"Trnavský kraj";4;0;0;0;NA;69457;4;2020-08-07;-203769
2020-08-06;"Trnavský kraj";4;0;0;0;NA;69457;4;2020-08-06;-203773
2020-08-05;"Trnavský kraj";0;0;0;0;NA;69457;0;2020-08-05;-203777
2020-08-04;"Trnavský kraj";1;0;0;0;NA;69457;1;2020-08-04;-203777
2020-08-03;"Trnavský kraj";2;0;0;0;NA;69457;2;2020-08-03;-203778
2020-08-02;"Trnavský kraj";1;0;0;0;NA;69457;1;2020-08-02;-203780
2020-08-01;"Trnavský kraj";0;0;0;0;NA;69457;0;2020-08-01;-203781
2020-07-31;"Trnavský kraj";7;0;0;0;NA;69457;7;2020-07-31;-203781
2020-07-30;"Trnavský kraj";6;0;0;0;NA;69457;6;2020-07-30;-203788
2020-07-29;"Trnavský kraj";0;0;0;0;NA;69457;0;2020-07-29;-203794
2020-07-28;"Trnavský kraj";1;0;0;0;NA;69457;1;2020-07-28;-203794
2020-07-27;"Trnavský kraj";2;0;0;0;NA;69457;2;2020-07-27;-203795
2020-07-26;"Trnavský kraj";0;0;0;0;NA;69457;0;2020-07-26;-203797
2020-07-25;"Trnavský kraj";0;0;0;0;NA;69457;0;2020-07-25;-203797
2020-07-24;"Trnavský kraj";1;0;0;0;NA;69457;1;2020-07-24;-203797
2020-07-23;"Trnavský kraj";2;0;0;0;NA;69457;2;2020-07-23;-203798
2020-07-22;"Trnavský kraj";1;0;0;0;NA;69457;1;2020-07-22;-203800
2020-07-21;"Trnavský kraj";2;0;0;0;NA;69457;2;2020-07-21;-203801
2020-07-20;"Trnavský kraj";0;0;0;0;NA;69457;0;2020-07-20;-203803
2020-07-19;"Trnavský kraj";0;0;0;0;NA;69457;0;2020-07-19;-203803
2020-07-18;"Trnavský kraj";0;0;0;0;NA;69457;0;2020-07-18;-203803
2020-07-17;"Trnavský kraj";0;0;0;0;NA;69457;0;2020-07-17;-203803
2020-07-16;"Trnavský kraj";0;0;0;0;NA;69457;0;2020-07-16;-203803
2020-07-15;"Trnavský kraj";1;0;0;0;NA;69457;1;2020-07-15;-203803
2020-07-14;"Trnavský kraj";0;0;0;0;NA;69457;0;2020-07-14;-203804
2020-07-13;"Trnavský kraj";0;0;0;0;NA;69457;0;2020-07-13;-203804
2020-07-12;"Trnavský kraj";0;0;0;0;NA;69457;0;2020-07-12;-203804
2020-07-11;"Trnavský kraj";0;0;0;0;NA;69457;0;2020-07-11;-203804
2020-07-10;"Trnavský kraj";0;0;0;0;NA;69457;0;2020-07-10;-203804
2020-07-09;"Trnavský kraj";0;0;0;0;NA;69457;0;2020-07-09;-203804
2020-07-08;"Trnavský kraj";3;0;0;0;NA;69457;3;2020-07-08;-203804
2020-07-07;"Trnavský kraj";4;0;0;0;NA;69457;4;2020-07-07;-203807
2020-07-06;"Trnavský kraj";0;0;0;0;NA;69457;0;2020-07-06;-203811
2020-07-05;"Trnavský kraj";0;0;0;0;NA;69457;0;2020-07-05;-203811
2020-07-04;"Trnavský kraj";0;0;0;0;NA;69457;0;2020-07-04;-203811
2020-07-03;"Trnavský kraj";0;0;0;0;NA;69457;0;2020-07-03;-203811
2020-07-02;"Trnavský kraj";3;0;0;0;NA;69457;3;2020-07-02;-203811
2020-07-01;"Trnavský kraj";0;0;0;0;NA;69457;0;2020-07-01;-203814
2020-06-30;"Trnavský kraj";0;0;0;0;NA;69457;0;2020-06-30;-203814
2020-06-29;"Trnavský kraj";0;0;0;0;NA;69457;0;2020-06-29;-203814
2020-06-28;"Trnavský kraj";0;0;0;0;NA;69457;0;2020-06-28;-203814
2020-06-27;"Trnavský kraj";0;0;0;0;NA;69457;0;2020-06-27;-203814
2020-06-26;"Trnavský kraj";0;0;0;0;NA;69457;0;2020-06-26;-203814
2020-06-25;"Trnavský kraj";0;0;0;0;NA;69457;0;2020-06-25;-203814
2020-06-24;"Trnavský kraj";0;0;0;0;NA;69457;0;2020-06-24;-203814
2020-06-23;"Trnavský kraj";0;0;0;0;NA;69457;0;2020-06-23;-203814
2020-06-22;"Trnavský kraj";0;0;0;0;NA;69457;0;2020-06-22;-203814
2020-06-21;"Trnavský kraj";0;0;0;0;NA;69457;0;2020-06-21;-203814
2020-06-20;"Trnavský kraj";0;0;0;0;NA;69457;0;2020-06-20;-203814
2020-06-19;"Trnavský kraj";0;0;0;0;NA;69457;0;2020-06-19;-203814
2020-06-18;"Trnavský kraj";2;0;0;0;NA;69457;2;2020-06-18;-203814
2020-06-17;"Trnavský kraj";0;0;0;0;NA;69457;0;2020-06-17;-203816
2020-06-16;"Trnavský kraj";0;0;0;0;NA;69457;0;2020-06-16;-203816
2020-06-14;"Trnavský kraj";0;0;0;0;NA;69457;0;2020-06-14;-203816
2020-06-13;"Trnavský kraj";0;0;0;0;NA;69457;0;2020-06-13;-203816
2020-06-12;"Trnavský kraj";0;0;0;0;NA;69457;0;2020-06-12;-203816
2020-06-11;"Trnavský kraj";0;0;0;0;NA;69457;0;2020-06-11;-203816
2020-06-10;"Trnavský kraj";0;0;0;0;NA;69457;0;2020-06-10;-203816
2020-06-09;"Trnavský kraj";0;0;0;0;NA;69457;0;2020-06-09;-203816
2020-06-08;"Trnavský kraj";0;0;0;0;NA;69457;0;2020-06-08;-203816
2020-06-07;"Trnavský kraj";0;0;0;0;NA;69457;0;2020-06-07;-203816
2020-06-05;"Trnavský kraj";0;0;0;0;NA;69457;0;2020-06-05;-203816
2020-06-03;"Trnavský kraj";0;0;0;0;NA;69457;0;2020-06-03;-203816
2020-06-02;"Trnavský kraj";0;0;0;0;NA;69457;0;2020-06-02;-203816
2020-05-31;"Trnavský kraj";0;0;0;0;NA;69457;0;2020-05-31;-203816
2020-05-29;"Trnavský kraj";0;0;0;0;NA;69457;0;2020-05-29;-203816
2020-05-27;"Trnavský kraj";0;0;0;0;NA;69457;0;2020-05-27;-203816
2020-05-26;"Trnavský kraj";0;0;0;0;NA;69457;0;2020-05-26;-203816
2020-05-25;"Trnavský kraj";1;0;0;0;NA;69457;1;2020-05-25;-203816
2020-05-24;"Trnavský kraj";0;0;0;0;NA;69457;0;2020-05-24;-203817
2020-05-23;"Trnavský kraj";2;0;0;0;NA;69457;2;2020-05-23;-203817
2020-05-22;"Trnavský kraj";0;0;0;0;NA;69457;0;2020-05-22;-203819
2020-05-21;"Trnavský kraj";0;0;0;0;NA;69457;0;2020-05-21;-203819
2020-05-20;"Trnavský kraj";2;0;0;0;NA;69457;2;2020-05-20;-203819
2020-05-19;"Trnavský kraj";0;0;0;0;NA;69457;0;2020-05-19;-203821
2020-05-17;"Trnavský kraj";0;0;0;0;NA;69457;0;2020-05-17;-203821
2020-05-16;"Trnavský kraj";0;0;0;0;NA;69457;0;2020-05-16;-203821
2020-05-15;"Trnavský kraj";1;0;0;0;NA;69457;1;2020-05-15;-203821
2020-05-14;"Trnavský kraj";0;0;0;0;NA;69457;0;2020-05-14;-203822
2020-05-13;"Trnavský kraj";0;0;0;0;NA;69457;0;2020-05-13;-203822
2020-05-12;"Trnavský kraj";0;0;0;0;NA;69457;0;2020-05-12;-203822
2020-05-11;"Trnavský kraj";2;0;0;0;NA;69457;2;2020-05-11;-203822
2020-05-09;"Trnavský kraj";0;0;0;0;NA;69457;0;2020-05-09;-203824
2020-05-07;"Trnavský kraj";0;0;0;0;NA;69457;0;2020-05-07;-203824
2020-05-06;"Trnavský kraj";0;0;0;0;NA;69457;0;2020-05-06;-203824
2020-05-05;"Trnavský kraj";0;0;0;0;NA;69457;0;2020-05-05;-203824
2020-05-04;"Trnavský kraj";0;0;0;0;NA;69457;0;2020-05-04;-203824
2020-05-03;"Trnavský kraj";0;0;0;0;NA;69457;0;2020-05-03;-203824
2020-05-02;"Trnavský kraj";0;0;0;0;NA;69457;0;2020-05-02;-203824
2020-05-01;"Trnavský kraj";0;0;0;0;NA;69457;0;2020-05-01;-203824
2020-04-30;"Trnavský kraj";0;0;0;0;NA;69457;0;2020-04-30;-203824
2020-04-29;"Trnavský kraj";0;0;0;0;NA;69457;0;2020-04-29;-203824
2020-04-28;"Trnavský kraj";1;0;0;0;NA;69457;1;2020-04-28;-203824
2020-04-27;"Trnavský kraj";0;0;0;0;NA;69457;0;2020-04-27;-203825
2020-04-26;"Trnavský kraj";0;0;0;0;NA;69457;0;2020-04-26;-203825
2020-04-25;"Trnavský kraj";2;0;0;0;NA;69457;2;2020-04-25;-203825
2020-04-24;"Trnavský kraj";4;0;0;0;NA;69457;4;2020-04-24;-203827
2020-04-23;"Trnavský kraj";5;0;0;0;NA;69457;5;2020-04-23;-203831
2020-04-22;"Trnavský kraj";10;0;0;0;NA;69457;10;2020-04-22;-203836
2020-04-21;"Trnavský kraj";5;0;0;0;NA;69457;5;2020-04-21;-203846
2020-04-20;"Trnavský kraj";0;0;0;0;NA;69457;0;2020-04-20;-203851
2020-04-19;"Trnavský kraj";1;0;0;0;NA;69457;1;2020-04-19;-203851
2020-04-18;"Trnavský kraj";4;0;0;0;NA;69457;4;2020-04-18;-203852
2020-04-17;"Trnavský kraj";7;0;0;0;NA;69457;7;2020-04-17;-203856
2020-04-16;"Trnavský kraj";5;0;0;0;NA;69457;5;2020-04-16;-203863
2020-04-15;"Trnavský kraj";5;0;0;0;NA;69457;5;2020-04-15;-203868
2020-04-14;"Trnavský kraj";1;0;0;0;NA;69457;1;2020-04-14;-203873
2020-04-13;"Trnavský kraj";0;0;0;0;NA;69457;0;2020-04-13;-203874
2020-04-12;"Trnavský kraj";0;0;0;0;NA;69457;0;2020-04-12;-203874
2020-04-11;"Trnavský kraj";0;0;0;0;NA;69457;0;2020-04-11;-203874
2020-04-10;"Trnavský kraj";2;0;0;0;NA;69457;2;2020-04-10;-203874
2020-04-09;"Trnavský kraj";3;0;0;0;NA;69457;3;2020-04-09;-203876
2020-04-08;"Trnavský kraj";4;0;0;0;NA;69457;4;2020-04-08;-203879
2020-04-07;"Trnavský kraj";6;0;0;0;NA;69457;6;2020-04-07;-203883
2020-04-06;"Trnavský kraj";6;0;0;0;NA;69457;6;2020-04-06;-203889
2020-04-05;"Trnavský kraj";1;0;0;0;NA;69457;1;2020-04-05;-203895
2020-04-04;"Trnavský kraj";1;0;0;0;NA;69457;1;2020-04-04;-203896
2020-04-03;"Trnavský kraj";3;0;0;0;NA;69457;3;2020-04-03;-203897
2020-04-02;"Trnavský kraj";4;0;0;0;NA;69457;4;2020-04-02;-203900
2020-04-01;"Trnavský kraj";0;0;0;0;NA;69457;0;2020-04-01;-203904
2020-03-31;"Trnavský kraj";3;0;0;0;NA;69457;3;2020-03-31;-203904
2020-03-30;"Trnavský kraj";4;0;0;0;NA;69457;4;2020-03-30;-203907
2020-03-29;"Trnavský kraj";1;0;0;0;NA;69457;1;2020-03-29;-203911
2020-03-28;"Trnavský kraj";3;0;0;0;NA;69457;3;2020-03-28;-203912
2020-03-27;"Trnavský kraj";5;0;0;0;NA;69457;5;2020-03-27;-203915
2020-03-26;"Trnavský kraj";5;0;0;0;NA;69457;5;2020-03-26;-203920
2020-03-25;"Trnavský kraj";1;0;0;0;NA;69457;1;2020-03-25;-203925
2020-03-24;"Trnavský kraj";0;0;0;0;NA;69457;0;2020-03-24;-203926
2020-03-23;"Trnavský kraj";2;0;0;0;NA;69457;2;2020-03-23;-203926
2020-03-22;"Trnavský kraj";1;0;0;0;NA;69457;1;2020-03-22;-203928
2020-03-21;"Trnavský kraj";5;0;0;0;NA;69457;5;2020-03-21;-203929
2020-03-20;"Trnavský kraj";0;0;0;0;NA;69457;0;2020-03-20;-203934
2020-03-19;"Trnavský kraj";0;0;0;0;NA;69457;0;2020-03-19;-203934
2020-03-18;"Trnavský kraj";0;0;0;0;NA;69457;0;2020-03-18;-203934
2020-03-17;"Trnavský kraj";3;0;0;0;NA;69457;3;2020-03-17;-203934
2020-03-16;"Trnavský kraj";1;0;0;0;NA;69457;1;2020-03-16;-203937
2020-03-15;"Trnavský kraj";0;0;0;0;NA;69457;0;2020-03-15;-203938
2020-03-14;"Trnavský kraj";0;0;0;0;NA;69457;0;2020-03-14;-203938
2020-03-13;"Trnavský kraj";1;0;0;0;NA;69457;1;2020-03-13;-203938
2020-03-12;"Trnavský kraj";1;0;0;0;NA;69457;1;2020-03-12;-203939
2020-03-11;"Trnavský kraj";0;0;0;0;NA;69457;0;2020-03-11;-203940
2020-03-09;"Trnavský kraj";0;0;0;0;NA;69457;0;2020-03-09;-203940
2020-03-08;"Trnavský kraj";0;0;0;0;NA;69457;0;2020-03-08;-203940
2020-03-07;"Trnavský kraj";0;0;0;0;NA;69457;0;2020-03-07;-203940
2020-03-06;"Trnavský kraj";0;0;0;0;NA;69457;0;2020-03-06;-203940
2022-06-26;"Žilinský kraj";11;8;2;10;NA;96516;13;2022-06-26;96516
2022-06-25;"Žilinský kraj";5;96;1;97;NA;96516;6;2022-06-25;96503
2022-06-24;"Žilinský kraj";32;201;7;208;NA;96516;39;2022-06-24;96497
2022-06-23;"Žilinský kraj";14;817;6;823;NA;96516;20;2022-06-23;96458
2022-06-22;"Žilinský kraj";40;257;14;271;NA;96516;54;2022-06-22;96438
2022-06-21;"Žilinský kraj";23;294;3;297;NA;96516;26;2022-06-21;96384
2022-06-20;"Žilinský kraj";33;175;6;181;NA;96516;39;2022-06-20;96358
2022-06-19;"Žilinský kraj";4;108;4;112;NA;96516;8;2022-06-19;96319
2022-06-18;"Žilinský kraj";7;71;1;72;NA;96516;8;2022-06-18;96311
2022-06-17;"Žilinský kraj";31;148;7;155;NA;96516;38;2022-06-17;96303
2022-06-16;"Žilinský kraj";17;291;7;298;NA;96516;24;2022-06-16;96265
2022-06-15;"Žilinský kraj";19;254;8;262;NA;96516;27;2022-06-15;96241
2022-06-14;"Žilinský kraj";24;221;10;231;NA;96516;34;2022-06-14;96214
2022-06-13;"Žilinský kraj";15;296;8;304;NA;96516;23;2022-06-13;96180
2022-06-12;"Žilinský kraj";1;52;1;53;NA;96516;2;2022-06-12;96157
2022-06-11;"Žilinský kraj";0;70;2;72;NA;96516;2;2022-06-11;96155
2022-06-10;"Žilinský kraj";12;244;8;252;NA;96516;20;2022-06-10;96153
2022-06-09;"Žilinský kraj";14;389;7;396;NA;96516;21;2022-06-09;96133
2022-06-08;"Žilinský kraj";22;173;6;179;NA;96516;28;2022-06-08;96112
2022-06-07;"Žilinský kraj";17;246;5;251;NA;96516;22;2022-06-07;96084
2022-06-06;"Žilinský kraj";20;483;9;492;NA;96516;29;2022-06-06;96062
2022-06-05;"Žilinský kraj";2;64;4;68;NA;96516;6;2022-06-05;96033
2022-06-04;"Žilinský kraj";5;88;1;89;NA;96516;6;2022-06-04;96027
2022-06-03;"Žilinský kraj";18;135;8;143;NA;96516;26;2022-06-03;96021
2022-06-02;"Žilinský kraj";8;224;4;228;NA;96516;12;2022-06-02;95995
2022-06-01;"Žilinský kraj";14;264;4;268;NA;96516;18;2022-06-01;95983
2022-05-31;"Žilinský kraj";14;245;7;252;NA;96516;21;2022-05-31;95965
2022-05-30;"Žilinský kraj";24;278;6;284;NA;96516;30;2022-05-30;95944
2022-05-29;"Žilinský kraj";1;117;0;117;NA;96516;1;2022-05-29;95914
2022-05-28;"Žilinský kraj";9;81;1;82;NA;96516;10;2022-05-28;95913
2022-05-27;"Žilinský kraj";11;239;4;243;NA;96516;15;2022-05-27;95903
2022-05-26;"Žilinský kraj";14;377;4;381;NA;96516;18;2022-05-26;95888
2022-05-25;"Žilinský kraj";24;157;10;167;NA;96516;34;2022-05-25;95870
2022-05-24;"Žilinský kraj";20;313;7;320;NA;96516;27;2022-05-24;95836
2022-05-23;"Žilinský kraj";29;364;9;373;NA;96516;38;2022-05-23;95809
2022-05-22;"Žilinský kraj";4;150;6;156;NA;96516;10;2022-05-22;95771
2022-05-21;"Žilinský kraj";13;91;0;91;NA;96516;13;2022-05-21;95761
2022-05-20;"Žilinský kraj";27;227;15;242;NA;96516;42;2022-05-20;95748
2022-05-19;"Žilinský kraj";22;324;7;331;NA;96516;29;2022-05-19;95706
2022-05-18;"Žilinský kraj";28;253;26;279;NA;96516;54;2022-05-18;95677
2022-05-17;"Žilinský kraj";46;288;11;299;NA;96516;57;2022-05-17;95623
2022-05-16;"Žilinský kraj";42;383;21;404;NA;96516;63;2022-05-16;95566
2022-05-15;"Žilinský kraj";1;128;7;135;NA;96516;8;2022-05-15;95503
2022-05-14;"Žilinský kraj";15;284;18;302;NA;96516;33;2022-05-14;95495
2022-05-13;"Žilinský kraj";40;385;26;411;NA;96516;66;2022-05-13;95462
2022-05-12;"Žilinský kraj";28;1081;24;1105;NA;96516;52;2022-05-12;95396
2022-05-11;"Žilinský kraj";41;501;24;525;NA;96516;65;2022-05-11;95344
2022-05-10;"Žilinský kraj";74;355;26;381;NA;96516;100;2022-05-10;95279
2022-05-09;"Žilinský kraj";52;515;49;564;NA;96516;101;2022-05-09;95179
2022-05-08;"Žilinský kraj";2;131;10;141;NA;96516;12;2022-05-08;95078
2022-05-07;"Žilinský kraj";27;257;27;284;NA;96516;54;2022-05-07;95066
2022-05-06;"Žilinský kraj";83;268;29;297;NA;96516;112;2022-05-06;95012
2022-05-05;"Žilinský kraj";55;527;30;557;NA;96516;85;2022-05-05;94900
2022-05-04;"Žilinský kraj";60;518;69;587;NA;96516;129;2022-05-04;94815
2022-05-03;"Žilinský kraj";108;537;34;571;NA;96516;142;2022-05-03;94686
2022-05-02;"Žilinský kraj";104;711;41;752;NA;96516;145;2022-05-02;94544
2022-05-01;"Žilinský kraj";15;124;9;133;NA;96516;24;2022-05-01;94399
2022-04-30;"Žilinský kraj";113;372;24;396;NA;96516;137;2022-04-30;94375
2022-04-29;"Žilinský kraj";127;842;29;871;NA;96516;156;2022-04-29;94238
2022-04-28;"Žilinský kraj";117;613;47;660;NA;96516;164;2022-04-28;94082
2022-04-27;"Žilinský kraj";125;874;16;890;NA;96516;141;2022-04-27;93918
2022-04-26;"Žilinský kraj";207;725;30;755;NA;96516;237;2022-04-26;93777
2022-04-25;"Žilinský kraj";218;1155;79;1234;NA;96516;297;2022-04-25;93540
2022-04-24;"Žilinský kraj";8;251;20;271;NA;96516;28;2022-04-24;93243
2022-04-23;"Žilinský kraj";212;391;22;413;NA;96516;234;2022-04-23;93215
2022-04-22;"Žilinský kraj";126;548;35;583;NA;96516;161;2022-04-22;92981
2022-04-21;"Žilinský kraj";218;781;63;844;NA;96516;281;2022-04-21;92820
2022-04-20;"Žilinský kraj";366;915;52;967;NA;96516;418;2022-04-20;92539
2022-04-19;"Žilinský kraj";346;1852;79;1931;NA;96516;425;2022-04-19;92121
2022-04-18;"Žilinský kraj";84;368;27;395;NA;96516;111;2022-04-18;91696
2022-04-17;"Žilinský kraj";157;175;13;188;NA;96516;170;2022-04-17;91585
2022-04-16;"Žilinský kraj";111;282;54;336;NA;96516;165;2022-04-16;91415
2022-04-15;"Žilinský kraj";43;223;11;234;NA;96516;54;2022-04-15;91250
2022-04-14;"Žilinský kraj";315;1195;53;1248;NA;96516;368;2022-04-14;91196
2022-04-13;"Žilinský kraj";331;1101;39;1140;NA;96516;370;2022-04-13;90828
2022-04-12;"Žilinský kraj";280;1079;42;1121;NA;96516;322;2022-04-12;90458
2022-04-11;"Žilinský kraj";453;1335;87;1422;NA;96516;540;2022-04-11;90136
2022-04-10;"Žilinský kraj";20;313;26;339;NA;96516;46;2022-04-10;89596
2022-04-09;"Žilinský kraj";233;261;38;299;NA;96516;271;2022-04-09;89550
2022-04-08;"Žilinský kraj";368;762;50;812;NA;96516;418;2022-04-08;89279
2022-04-07;"Žilinský kraj";359;797;54;851;NA;96516;413;2022-04-07;88861
2022-04-06;"Žilinský kraj";541;1030;69;1099;NA;96516;610;2022-04-06;88448
2022-04-05;"Žilinský kraj";699;1038;78;1116;NA;96516;777;2022-04-05;87838
2022-04-04;"Žilinský kraj";605;1340;110;1450;NA;96516;715;2022-04-04;87061
2022-04-03;"Žilinský kraj";82;268;34;302;NA;96516;116;2022-04-03;86346
2022-04-02;"Žilinský kraj";289;224;33;257;NA;96516;322;2022-04-02;86230
2022-04-01;"Žilinský kraj";592;943;60;1003;NA;96516;652;2022-04-01;85908
2022-03-31;"Žilinský kraj";557;863;92;955;NA;96516;649;2022-03-31;85256
2022-03-30;"Žilinský kraj";688;1644;102;1746;NA;96516;790;2022-03-30;84607
2022-03-29;"Žilinský kraj";755;917;103;1020;NA;96516;858;2022-03-29;83817
2022-03-28;"Žilinský kraj";825;1744;141;1885;NA;96516;966;2022-03-28;82959
2022-03-27;"Žilinský kraj";88;414;91;505;NA;96516;179;2022-03-27;81993
2022-03-26;"Žilinský kraj";586;224;53;277;NA;96516;639;2022-03-26;81814
2022-03-25;"Žilinský kraj";601;866;100;966;NA;96516;701;2022-03-25;81175
2022-03-24;"Žilinský kraj";697;1433;100;1533;NA;96516;797;2022-03-24;80474
2022-03-23;"Žilinský kraj";883;940;103;1043;NA;96516;986;2022-03-23;79677
2022-03-22;"Žilinský kraj";1102;2516;136;2652;NA;96516;1238;2022-03-22;78691
2022-03-21;"Žilinský kraj";969;1921;163;2084;NA;96516;1132;2022-03-21;77453
2022-03-20;"Žilinský kraj";157;438;88;526;NA;96516;245;2022-03-20;76321
2022-03-19;"Žilinský kraj";479;340;69;409;NA;96516;548;2022-03-19;76076
2022-03-18;"Žilinský kraj";864;773;119;892;NA;96516;983;2022-03-18;75528
2022-03-17;"Žilinský kraj";733;1120;154;1274;NA;96516;887;2022-03-17;74545
2022-03-16;"Žilinský kraj";995;1371;165;1536;NA;96516;1160;2022-03-16;73658
2022-03-15;"Žilinský kraj";1252;2522;215;2737;NA;96516;1467;2022-03-15;72498
2022-03-14;"Žilinský kraj";1138;1546;209;1755;NA;96516;1347;2022-03-14;71031
2022-03-13;"Žilinský kraj";226;522;112;634;NA;96516;338;2022-03-13;69684
2022-03-12;"Žilinský kraj";650;346;94;440;NA;96516;744;2022-03-12;69346
2022-03-11;"Žilinský kraj";824;1755;197;1952;NA;96516;1021;2022-03-11;68602
2022-03-10;"Žilinský kraj";1249;1519;169;1688;NA;96516;1418;2022-03-10;67581
2022-03-09;"Žilinský kraj";1713;1457;206;1663;NA;96516;1919;2022-03-09;66163
2022-03-08;"Žilinský kraj";699;2333;311;2644;NA;96516;1010;2022-03-08;64244
2022-03-07;"Žilinský kraj";1448;2225;300;2525;NA;96516;1748;2022-03-07;63234
2022-03-06;"Žilinský kraj";323;797;211;1008;NA;96516;534;2022-03-06;61486
2022-03-05;"Žilinský kraj";576;572;129;701;NA;96516;705;2022-03-05;60952
2022-03-04;"Žilinský kraj";1194;1884;264;2148;NA;96516;1458;2022-03-04;60247
2022-03-03;"Žilinský kraj";1240;1852;247;2099;NA;96516;1487;2022-03-03;58789
2022-03-02;"Žilinský kraj";1194;1798;250;2048;NA;96516;1444;2022-03-02;57302
2022-03-01;"Žilinský kraj";1710;2974;347;3321;NA;96516;2057;2022-03-01;55858
2022-02-28;"Žilinský kraj";1700;2980;355;3335;NA;96516;2055;2022-02-28;53801
2022-02-27;"Žilinský kraj";224;940;221;1161;NA;96516;445;2022-02-27;51746
2022-02-26;"Žilinský kraj";1184;816;171;987;NA;96516;1355;2022-02-26;51301
2022-02-25;"Žilinský kraj";1371;2421;320;2741;NA;96516;1691;2022-02-25;49946
2022-02-24;"Žilinský kraj";1504;2589;314;2903;NA;96516;1818;2022-02-24;48255
2022-02-23;"Žilinský kraj";1766;3298;333;3631;NA;96516;2099;2022-02-23;46437
2022-02-22;"Žilinský kraj";2419;3369;406;3775;NA;96516;2825;2022-02-22;44338
2022-02-21;"Žilinský kraj";2227;4183;573;4756;NA;96516;2800;2022-02-21;41513
2022-02-20;"Žilinský kraj";541;1473;304;1777;NA;96516;845;2022-02-20;38713
2022-02-19;"Žilinský kraj";1656;944;273;1217;NA;96516;1929;2022-02-19;37868
2022-02-18;"Žilinský kraj";1994;3339;439;3778;NA;96516;2433;2022-02-18;35939
2022-02-17;"Žilinský kraj";2274;3019;424;3443;NA;96516;2698;2022-02-17;33506
2022-02-16;"Žilinský kraj";2676;3579;496;4075;NA;96516;3172;2022-02-16;30808
2022-02-15;"Žilinský kraj";2939;4226;604;4830;NA;96516;3543;2022-02-15;27636
2022-02-14;"Žilinský kraj";2955;4182;777;4959;NA;96516;3732;2022-02-14;24093
2022-02-13;"Žilinský kraj";751;1842;464;2306;NA;96516;1215;2022-02-13;20361
2022-02-12;"Žilinský kraj";1771;1431;319;1750;NA;96516;2090;2022-02-12;19146
2022-02-11;"Žilinský kraj";2856;3332;570;3902;NA;96516;3426;2022-02-11;17056
2022-02-10;"Žilinský kraj";2861;3472;583;4055;NA;96516;3444;2022-02-10;13630
2022-02-09;"Žilinský kraj";3365;3863;618;4481;NA;96516;3983;2022-02-09;10186
2022-02-08;"Žilinský kraj";3367;4866;780;5646;NA;96516;4147;2022-02-08;6203
2022-02-07;"Žilinský kraj";3242;5569;913;6482;NA;96516;4155;2022-02-07;2056
2022-02-06;"Žilinský kraj";1389;2587;529;3116;NA;96516;1918;2022-02-06;-2099
2022-02-05;"Žilinský kraj";2107;1846;425;2271;NA;96516;2532;2022-02-05;-4017
2022-02-04;"Žilinský kraj";3099;4389;631;5020;NA;96516;3730;2022-02-04;-6549
2022-02-03;"Žilinský kraj";3201;4122;613;4735;NA;96516;3814;2022-02-03;-10279
2022-02-02;"Žilinský kraj";3168;4616;666;5282;NA;96516;3834;2022-02-02;-14093
2022-02-01;"Žilinský kraj";3593;5240;694;5934;NA;96516;4287;2022-02-01;-17927
2022-01-31;"Žilinský kraj";2145;7492;931;8423;NA;96516;3076;2022-01-31;-22214
2022-01-30;"Žilinský kraj";1487;2898;431;3329;NA;96516;1918;2022-01-30;-25290
2022-01-29;"Žilinský kraj";2055;2033;365;2398;NA;96516;2420;2022-01-29;-27208
2022-01-28;"Žilinský kraj";2572;4800;546;5346;NA;96516;3118;2022-01-28;-29628
2022-01-27;"Žilinský kraj";2406;4038;537;4575;NA;96516;2943;2022-01-27;-32746
2022-01-26;"Žilinský kraj";2693;5009;516;5525;NA;96516;3209;2022-01-26;-35689
2022-01-25;"Žilinský kraj";2595;5626;416;6042;NA;96516;3011;2022-01-25;-38898
2022-01-24;"Žilinský kraj";1401;7098;522;7620;NA;96516;1923;2022-01-24;-41909
2022-01-23;"Žilinský kraj";654;2923;276;3199;NA;96516;930;2022-01-23;-43832
2022-01-22;"Žilinský kraj";1256;1706;206;1912;NA;96516;1462;2022-01-22;-44762
2022-01-21;"Žilinský kraj";1188;4187;265;4452;NA;96516;1453;2022-01-21;-46224
2022-01-20;"Žilinský kraj";1288;3654;205;3859;NA;96516;1493;2022-01-20;-47677
2022-01-19;"Žilinský kraj";1215;4086;206;4292;NA;96516;1421;2022-01-19;-49170
2022-01-18;"Žilinský kraj";1191;4213;168;4381;NA;96516;1359;2022-01-18;-50591
2022-01-17;"Žilinský kraj";675;6886;256;7142;NA;96516;931;2022-01-17;-51950
2022-01-16;"Žilinský kraj";175;2418;106;2524;NA;96516;281;2022-01-16;-52881
2022-01-15;"Žilinský kraj";398;1410;70;1480;NA;96516;468;2022-01-15;-53162
2022-01-14;"Žilinský kraj";446;3716;106;3822;NA;96516;552;2022-01-14;-53630
2022-01-13;"Žilinský kraj";295;2912;78;2990;NA;96516;373;2022-01-13;-54182
2022-01-12;"Žilinský kraj";422;3168;72;3240;NA;96516;494;2022-01-12;-54555
2022-01-11;"Žilinský kraj";622;4216;57;4273;NA;96516;679;2022-01-11;-55049
2022-01-10;"Žilinský kraj";436;6344;102;6446;NA;96516;538;2022-01-10;-55728
2022-01-09;"Žilinský kraj";95;2934;54;2988;NA;96516;149;2022-01-09;-56266
2022-01-08;"Žilinský kraj";345;1650;45;1695;NA;96516;390;2022-01-08;-56415
2022-01-07;"Žilinský kraj";525;4566;75;4641;NA;96516;600;2022-01-07;-56805
2022-01-06;"Žilinský kraj";167;1214;40;1254;NA;96516;207;2022-01-06;-57405
2022-01-05;"Žilinský kraj";471;3492;75;3567;NA;96516;546;2022-01-05;-57612
2022-01-04;"Žilinský kraj";606;3762;87;3849;NA;96516;693;2022-01-04;-58158
2022-01-03;"Žilinský kraj";601;6083;116;6199;NA;96516;717;2022-01-03;-58851
2022-01-02;"Žilinský kraj";288;2596;85;2681;NA;96516;373;2022-01-02;-59568
2022-01-01;"Žilinský kraj";14;439;15;454;NA;96516;29;2022-01-01;-59941
2021-12-31;"Žilinský kraj";323;1608;70;1678;NA;96516;393;2021-12-31;-59970
2021-12-30;"Žilinský kraj";492;2213;95;2308;NA;96516;587;2021-12-30;-60363
2021-12-29;"Žilinský kraj";543;6864;83;6947;NA;96516;626;2021-12-29;-60950
2021-12-28;"Žilinský kraj";641;3408;106;3514;NA;96516;747;2021-12-28;-61576
2021-12-27;"Žilinský kraj";691;3961;145;4106;NA;96516;836;2021-12-27;-62323
2021-12-26;"Žilinský kraj";242;1167;58;1225;NA;96516;300;2021-12-26;-63159
2021-12-25;"Žilinský kraj";22;442;45;487;NA;96516;67;2021-12-25;-63459
2021-12-24;"Žilinský kraj";98;518;21;539;NA;96516;119;2021-12-24;-63526
2021-12-23;"Žilinský kraj";731;2678;105;2783;NA;96516;836;2021-12-23;-63645
2021-12-22;"Žilinský kraj";510;2428;77;2505;NA;96516;587;2021-12-22;-64481
2021-12-21;"Žilinský kraj";755;3641;102;3743;NA;96516;857;2021-12-21;-65068
2021-12-20;"Žilinský kraj";563;4545;125;4670;NA;96516;688;2021-12-20;-65925
2021-12-19;"Žilinský kraj";133;2215;90;2305;NA;96516;223;2021-12-19;-66613
2021-12-18;"Žilinský kraj";417;1321;70;1391;NA;96516;487;2021-12-18;-66836
2021-12-17;"Žilinský kraj";604;3895;127;4022;NA;96516;731;2021-12-17;-67323
2021-12-16;"Žilinský kraj";660;3931;109;4040;NA;96516;769;2021-12-16;-68054
2021-12-15;"Žilinský kraj";802;3491;122;3613;NA;96516;924;2021-12-15;-68823
2021-12-14;"Žilinský kraj";798;4587;129;4716;NA;96516;927;2021-12-14;-69747
2021-12-13;"Žilinský kraj";759;7755;212;7967;NA;96516;971;2021-12-13;-70674
2021-12-12;"Žilinský kraj";340;2836;114;2950;NA;96516;454;2021-12-12;-71645
2021-12-11;"Žilinský kraj";761;1849;112;1961;NA;96516;873;2021-12-11;-72099
2021-12-10;"Žilinský kraj";638;4041;136;4177;NA;96516;774;2021-12-10;-72972
2021-12-09;"Žilinský kraj";870;5842;161;6003;NA;96516;1031;2021-12-09;-73746
2021-12-08;"Žilinský kraj";1018;3215;158;3373;NA;96516;1176;2021-12-08;-74777
2021-12-07;"Žilinský kraj";1356;5148;160;5308;NA;96516;1516;2021-12-07;-75953
2021-12-06;"Žilinský kraj";919;7441;226;7667;NA;96516;1145;2021-12-06;-77469
2021-12-05;"Žilinský kraj";505;3306;134;3440;NA;96516;639;2021-12-05;-78614
2021-12-04;"Žilinský kraj";704;1892;153;2045;NA;96516;857;2021-12-04;-79253
2021-12-03;"Žilinský kraj";1204;4864;215;5079;NA;96516;1419;2021-12-03;-80110
2021-12-02;"Žilinský kraj";1847;4131;199;4330;NA;96516;2046;2021-12-02;-81529
2021-12-01;"Žilinský kraj";1183;4073;195;4268;NA;96516;1378;2021-12-01;-83575
2021-11-30;"Žilinský kraj";1575;5467;252;5719;NA;96516;1827;2021-11-30;-84953
2021-11-29;"Žilinský kraj";1395;9069;358;9427;NA;96516;1753;2021-11-29;-86780
2021-11-28;"Žilinský kraj";625;4581;235;4816;NA;96516;860;2021-11-28;-88533
2021-11-27;"Žilinský kraj";909;2557;192;2749;NA;96516;1101;2021-11-27;-89393
2021-11-26;"Žilinský kraj";1195;6599;344;6943;NA;96516;1539;2021-11-26;-90494
2021-11-25;"Žilinský kraj";1281;4701;331;5032;NA;96516;1612;2021-11-25;-92033
2021-11-24;"Žilinský kraj";1792;4660;324;4984;NA;96516;2116;2021-11-24;-93645
2021-11-23;"Žilinský kraj";1630;4654;353;5007;NA;96516;1983;2021-11-23;-95761
2021-11-22;"Žilinský kraj";1126;6699;452;7151;NA;96516;1578;2021-11-22;-97744
2021-11-21;"Žilinský kraj";443;2865;260;3125;NA;96516;703;2021-11-21;-99322
2021-11-20;"Žilinský kraj";963;2104;241;2345;NA;96516;1204;2021-11-20;-100025
2021-11-19;"Žilinský kraj";1281;4622;434;5056;NA;96516;1715;2021-11-19;-101229
2021-11-18;"Žilinský kraj";1220;4432;376;4808;NA;96516;1596;2021-11-18;-102944
2021-11-17;"Žilinský kraj";1001;1434;149;1583;NA;96516;1150;2021-11-17;-104540
2021-11-16;"Žilinský kraj";1197;4058;323;4381;NA;96516;1520;2021-11-16;-105690
2021-11-15;"Žilinský kraj";977;5050;476;5526;NA;96516;1453;2021-11-15;-107210
2021-11-14;"Žilinský kraj";356;2287;262;2549;NA;96516;618;2021-11-14;-108663
2021-11-13;"Žilinský kraj";652;1882;220;2102;NA;96516;872;2021-11-13;-109281
2021-11-12;"Žilinský kraj";1027;4291;340;4631;NA;96516;1367;2021-11-12;-110153
2021-11-11;"Žilinský kraj";924;4192;272;4464;NA;96516;1196;2021-11-11;-111520
2021-11-10;"Žilinský kraj";897;4509;305;4814;NA;96516;1202;2021-11-10;-112716
2021-11-09;"Žilinský kraj";1440;4619;256;4875;NA;96516;1696;2021-11-09;-113918
2021-11-08;"Žilinský kraj";781;4438;425;4863;NA;96516;1206;2021-11-08;-115614
2021-11-07;"Žilinský kraj";304;2130;231;2361;NA;96516;535;2021-11-07;-116820
2021-11-06;"Žilinský kraj";741;2150;201;2351;NA;96516;942;2021-11-06;-117355
2021-11-05;"Žilinský kraj";1064;4067;235;4302;NA;96516;1299;2021-11-05;-118297
2021-11-04;"Žilinský kraj";776;3709;232;3941;NA;96516;1008;2021-11-04;-119596
2021-11-03;"Žilinský kraj";1106;5550;338;5888;NA;96516;1444;2021-11-03;-120604
2021-11-02;"Žilinský kraj";1136;4451;333;4784;NA;96516;1469;2021-11-02;-122048
2021-11-01;"Žilinský kraj";399;1456;137;1593;NA;96516;536;2021-11-01;-123517
2021-10-31;"Žilinský kraj";344;1387;145;1532;NA;96516;489;2021-10-31;-124053
2021-10-30;"Žilinský kraj";571;1944;161;2105;NA;96516;732;2021-10-30;-124542
2021-10-29;"Žilinský kraj";733;3339;194;3533;NA;96516;927;2021-10-29;-125274
2021-10-28;"Žilinský kraj";639;4953;247;5200;NA;96516;886;2021-10-28;-126201
2021-10-27;"Žilinský kraj";739;3446;173;3619;NA;96516;912;2021-10-27;-127087
2021-10-26;"Žilinský kraj";945;4748;216;4964;NA;96516;1161;2021-10-26;-127999
2021-10-25;"Žilinský kraj";649;5736;271;6007;NA;96516;920;2021-10-25;-129160
2021-10-24;"Žilinský kraj";248;1679;107;1786;NA;96516;355;2021-10-24;-130080
2021-10-23;"Žilinský kraj";399;2415;149;2564;NA;96516;548;2021-10-23;-130435
2021-10-22;"Žilinský kraj";587;3898;151;4049;NA;96516;738;2021-10-22;-130983
2021-10-21;"Žilinský kraj";591;3367;162;3529;NA;96516;753;2021-10-21;-131721
2021-10-20;"Žilinský kraj";479;3864;154;4018;NA;96516;633;2021-10-20;-132474
2021-10-19;"Žilinský kraj";675;3763;161;3924;NA;96516;836;2021-10-19;-133107
2021-10-18;"Žilinský kraj";432;5160;271;5431;NA;96516;703;2021-10-18;-133943
2021-10-17;"Žilinský kraj";135;1769;101;1870;NA;96516;236;2021-10-17;-134646
2021-10-16;"Žilinský kraj";273;2341;100;2441;NA;96516;373;2021-10-16;-134882
2021-10-15;"Žilinský kraj";347;3859;146;4005;NA;96516;493;2021-10-15;-135255
2021-10-14;"Žilinský kraj";419;3035;110;3145;NA;96516;529;2021-10-14;-135748
2021-10-13;"Žilinský kraj";404;3427;112;3539;NA;96516;516;2021-10-13;-136277
2021-10-12;"Žilinský kraj";589;4000;141;4141;NA;96516;730;2021-10-12;-136793
2021-10-11;"Žilinský kraj";323;4501;154;4655;NA;96516;477;2021-10-11;-137523
2021-10-10;"Žilinský kraj";113;1577;77;1654;NA;96516;190;2021-10-10;-138000
2021-10-09;"Žilinský kraj";201;1565;57;1622;NA;96516;258;2021-10-09;-138190
2021-10-08;"Žilinský kraj";265;4227;99;4326;NA;96516;364;2021-10-08;-138448
2021-10-07;"Žilinský kraj";338;3384;113;3497;NA;96516;451;2021-10-07;-138812
2021-10-06;"Žilinský kraj";313;3901;89;3990;NA;96516;402;2021-10-06;-139263
2021-10-05;"Žilinský kraj";387;4031;122;4153;NA;96516;509;2021-10-05;-139665
2021-10-04;"Žilinský kraj";297;4449;121;4570;NA;96516;418;2021-10-04;-140174
2021-10-03;"Žilinský kraj";22;1596;63;1659;NA;96516;85;2021-10-03;-140592
2021-10-02;"Žilinský kraj";209;1990;45;2035;NA;96516;254;2021-10-02;-140677
2021-10-01;"Žilinský kraj";263;4047;104;4151;NA;96516;367;2021-10-01;-140931
2021-09-30;"Žilinský kraj";248;3531;71;3602;NA;96516;319;2021-09-30;-141298
2021-09-29;"Žilinský kraj";285;3577;82;3659;NA;96516;367;2021-09-29;-141617
2021-09-28;"Žilinský kraj";272;3656;73;3729;NA;96516;345;2021-09-28;-141984
2021-09-27;"Žilinský kraj";239;4418;152;4570;NA;96516;391;2021-09-27;-142329
2021-09-26;"Žilinský kraj";17;1665;42;1707;NA;96516;59;2021-09-26;-142720
2021-09-25;"Žilinský kraj";111;1711;50;1761;NA;96516;161;2021-09-25;-142779
2021-09-24;"Žilinský kraj";199;6137;98;6235;NA;96516;297;2021-09-24;-142940
2021-09-23;"Žilinský kraj";176;2629;74;2703;NA;96516;250;2021-09-23;-143237
2021-09-22;"Žilinský kraj";185;2728;77;2805;NA;96516;262;2021-09-22;-143487
2021-09-21;"Žilinský kraj";250;3123;78;3201;NA;96516;328;2021-09-21;-143749
2021-09-20;"Žilinský kraj";244;3231;95;3326;NA;96516;339;2021-09-20;-144077
2021-09-19;"Žilinský kraj";26;1579;37;1616;NA;96516;63;2021-09-19;-144416
2021-09-18;"Žilinský kraj";87;1441;45;1486;NA;96516;132;2021-09-18;-144479
2021-09-17;"Žilinský kraj";192;3351;56;3407;NA;96516;248;2021-09-17;-144611
2021-09-16;"Žilinský kraj";164;2744;87;2831;NA;96516;251;2021-09-16;-144859
2021-09-15;"Žilinský kraj";31;555;11;566;NA;96516;42;2021-09-15;-145110
2021-09-14;"Žilinský kraj";155;3268;61;3329;NA;96516;216;2021-09-14;-145152
2021-09-13;"Žilinský kraj";81;3250;75;3325;NA;96516;156;2021-09-13;-145368
2021-09-12;"Žilinský kraj";9;1138;24;1162;NA;96516;33;2021-09-12;-145524
2021-09-11;"Žilinský kraj";47;1322;21;1343;NA;96516;68;2021-09-11;-145557
2021-09-10;"Žilinský kraj";66;2439;34;2473;NA;96516;100;2021-09-10;-145625
2021-09-09;"Žilinský kraj";56;2352;18;2370;NA;96516;74;2021-09-09;-145725
2021-09-08;"Žilinský kraj";68;1560;24;1584;NA;96516;92;2021-09-08;-145799
2021-09-07;"Žilinský kraj";72;1806;27;1833;NA;96516;99;2021-09-07;-145891
2021-09-06;"Žilinský kraj";31;2381;45;2426;NA;96516;76;2021-09-06;-145990
2021-09-05;"Žilinský kraj";11;785;8;793;NA;96516;19;2021-09-05;-146066
2021-09-04;"Žilinský kraj";24;1080;5;1085;NA;96516;29;2021-09-04;-146085
2021-09-03;"Žilinský kraj";52;2047;28;2075;NA;96516;80;2021-09-03;-146114
2021-09-02;"Žilinský kraj";30;1432;22;1454;NA;96516;52;2021-09-02;-146194
2021-09-01;"Žilinský kraj";5;461;6;467;NA;96516;11;2021-09-01;-146246
2021-08-31;"Žilinský kraj";32;1710;15;1725;NA;96516;47;2021-08-31;-146257
2021-08-30;"Žilinský kraj";7;1801;4;1805;NA;96516;11;2021-08-30;-146304
2021-08-29;"Žilinský kraj";8;631;5;636;NA;96516;13;2021-08-29;-146315
2021-08-28;"Žilinský kraj";2;1005;1;1006;NA;96516;3;2021-08-28;-146328
2021-08-27;"Žilinský kraj";13;1765;12;1777;NA;96516;25;2021-08-27;-146331
2021-08-26;"Žilinský kraj";17;1636;7;1643;NA;96516;24;2021-08-26;-146356
2021-08-25;"Žilinský kraj";9;1203;11;1214;NA;96516;20;2021-08-25;-146380
2021-08-24;"Žilinský kraj";6;1395;9;1404;NA;96516;15;2021-08-24;-146400
2021-08-23;"Žilinský kraj";11;1877;7;1884;NA;96516;18;2021-08-23;-146415
2021-08-22;"Žilinský kraj";2;733;3;736;NA;96516;5;2021-08-22;-146433
2021-08-21;"Žilinský kraj";6;1183;2;1185;NA;96516;8;2021-08-21;-146438
2021-08-20;"Žilinský kraj";7;2284;5;2289;NA;96516;12;2021-08-20;-146446
2021-08-19;"Žilinský kraj";6;1281;3;1284;NA;96516;9;2021-08-19;-146458
2021-08-18;"Žilinský kraj";4;1331;7;1338;NA;96516;11;2021-08-18;-146467
2021-08-17;"Žilinský kraj";9;1219;3;1222;NA;96516;12;2021-08-17;-146478
2021-08-16;"Žilinský kraj";14;1696;5;1701;NA;96516;19;2021-08-16;-146490
2021-08-15;"Žilinský kraj";1;880;2;882;NA;96516;3;2021-08-15;-146509
2021-08-14;"Žilinský kraj";5;1197;0;1197;NA;96516;5;2021-08-14;-146512
2021-08-13;"Žilinský kraj";6;1685;0;1685;NA;96516;6;2021-08-13;-146517
2021-08-12;"Žilinský kraj";4;1105;1;1106;NA;96516;5;2021-08-12;-146523
2021-08-11;"Žilinský kraj";13;1250;3;1253;NA;96516;16;2021-08-11;-146528
2021-08-10;"Žilinský kraj";12;1292;3;1295;NA;96516;15;2021-08-10;-146544
2021-08-09;"Žilinský kraj";9;1142;1;1143;NA;96516;10;2021-08-09;-146559
2021-08-08;"Žilinský kraj";1;748;5;753;NA;96516;6;2021-08-08;-146569
2021-08-07;"Žilinský kraj";7;1192;1;1193;NA;96516;8;2021-08-07;-146575
2021-08-06;"Žilinský kraj";1;1347;0;1347;NA;96516;1;2021-08-06;-146583
2021-08-05;"Žilinský kraj";7;1148;3;1151;NA;96516;10;2021-08-05;-146584
2021-08-04;"Žilinský kraj";12;895;0;895;NA;96516;12;2021-08-04;-146594
2021-08-03;"Žilinský kraj";11;918;0;918;NA;96516;11;2021-08-03;-146606
2021-08-02;"Žilinský kraj";5;1513;1;1514;NA;96516;6;2021-08-02;-146617
2021-08-01;"Žilinský kraj";0;679;2;681;NA;96516;2;2021-08-01;-146623
2021-07-31;"Žilinský kraj";4;1114;0;1114;NA;96516;4;2021-07-31;-146625
2021-07-30;"Žilinský kraj";3;1671;0;1671;NA;96516;3;2021-07-30;-146629
2021-07-29;"Žilinský kraj";1;1299;0;1299;NA;96516;1;2021-07-29;-146632
2021-07-28;"Žilinský kraj";4;901;0;901;NA;96516;4;2021-07-28;-146633
2021-07-27;"Žilinský kraj";11;1378;0;1378;NA;96516;11;2021-07-27;-146637
2021-07-26;"Žilinský kraj";1;1301;1;1302;NA;96516;2;2021-07-26;-146648
2021-07-25;"Žilinský kraj";2;828;2;830;NA;96516;4;2021-07-25;-146650
2021-07-24;"Žilinský kraj";2;1338;2;1340;NA;96516;4;2021-07-24;-146654
2021-07-23;"Žilinský kraj";4;1750;0;1750;NA;96516;4;2021-07-23;-146658
2021-07-22;"Žilinský kraj";2;1207;0;1207;NA;96516;2;2021-07-22;-146662
2021-07-21;"Žilinský kraj";2;1021;0;1021;NA;96516;2;2021-07-21;-146664
2021-07-20;"Žilinský kraj";4;1439;0;1439;NA;96516;4;2021-07-20;-146666
2021-07-19;"Žilinský kraj";4;1763;1;1764;NA;96516;5;2021-07-19;-146670
2021-07-18;"Žilinský kraj";0;854;1;855;NA;96516;1;2021-07-18;-146675
2021-07-17;"Žilinský kraj";0;1350;0;1350;NA;96516;0;2021-07-17;-146676
2021-07-16;"Žilinský kraj";2;1767;0;1767;NA;96516;2;2021-07-16;-146676
2021-07-15;"Žilinský kraj";2;1577;0;1577;NA;96516;2;2021-07-15;-146678
2021-07-14;"Žilinský kraj";5;1042;1;1043;NA;96516;6;2021-07-14;-146680
2021-07-13;"Žilinský kraj";3;1709;1;1710;NA;96516;4;2021-07-13;-146686
2021-07-12;"Žilinský kraj";3;1325;1;1326;NA;96516;4;2021-07-12;-146690
2021-07-11;"Žilinský kraj";2;989;0;989;NA;96516;2;2021-07-11;-146694
2021-07-10;"Žilinský kraj";1;1511;4;1515;NA;96516;5;2021-07-10;-146696
2021-07-09;"Žilinský kraj";1;2208;1;2209;NA;96516;2;2021-07-09;-146701
2021-07-08;"Žilinský kraj";6;1776;3;1779;NA;96516;9;2021-07-08;-146703
2021-07-07;"Žilinský kraj";1;1585;3;1588;NA;96516;4;2021-07-07;-146712
2021-07-06;"Žilinský kraj";4;1956;0;1956;NA;96516;4;2021-07-06;-146716
2021-07-05;"Žilinský kraj";2;1031;1;1032;NA;96516;3;2021-07-05;-146720
2021-07-04;"Žilinský kraj";0;1003;0;1003;NA;96516;0;2021-07-04;-146723
2021-07-03;"Žilinský kraj";1;1696;2;1698;NA;96516;3;2021-07-03;-146723
2021-07-02;"Žilinský kraj";0;3356;2;3358;NA;96516;2;2021-07-02;-146726
2021-07-01;"Žilinský kraj";1;1118;0;1118;NA;96516;1;2021-07-01;-146728
2021-06-30;"Žilinský kraj";1;10464;6;10470;NA;96516;7;2021-06-30;-146729
2021-06-29;"Žilinský kraj";10;5946;0;5946;NA;96516;10;2021-06-29;-146736
2021-06-28;"Žilinský kraj";4;6245;2;6247;NA;96516;6;2021-06-28;-146746
2021-06-27;"Žilinský kraj";3;4702;1;4703;NA;96516;4;2021-06-27;-146752
2021-06-26;"Žilinský kraj";4;5919;0;5919;NA;96516;4;2021-06-26;-146756
2021-06-25;"Žilinský kraj";8;9756;5;9761;NA;96516;13;2021-06-25;-146760
2021-06-24;"Žilinský kraj";6;5657;3;5660;NA;96516;9;2021-06-24;-146773
2021-06-23;"Žilinský kraj";7;5955;10;5965;NA;96516;17;2021-06-23;-146782
2021-06-22;"Žilinský kraj";6;5214;8;5222;NA;96516;14;2021-06-22;-146799
2021-06-21;"Žilinský kraj";6;6287;8;6295;NA;96516;14;2021-06-21;-146813
2021-06-20;"Žilinský kraj";1;5531;8;5539;NA;96516;9;2021-06-20;-146827
2021-06-19;"Žilinský kraj";9;8353;2;8355;NA;96516;11;2021-06-19;-146836
2021-06-18;"Žilinský kraj";11;10624;12;10636;NA;96516;23;2021-06-18;-146847
2021-06-17;"Žilinský kraj";10;6092;12;6104;NA;96516;22;2021-06-17;-146870
2021-06-16;"Žilinský kraj";17;5786;11;5797;NA;96516;28;2021-06-16;-146892
2021-06-15;"Žilinský kraj";13;5996;13;6009;NA;96516;26;2021-06-15;-146920
2021-06-14;"Žilinský kraj";10;7596;21;7617;NA;96516;31;2021-06-14;-146946
2021-06-13;"Žilinský kraj";2;6682;9;6691;NA;96516;11;2021-06-13;-146977
2021-06-12;"Žilinský kraj";9;8634;11;8645;NA;96516;20;2021-06-12;-146988
2021-06-11;"Žilinský kraj";11;11566;14;11580;NA;96516;25;2021-06-11;-147008
2021-06-10;"Žilinský kraj";14;6788;14;6802;NA;96516;28;2021-06-10;-147033
2021-06-09;"Žilinský kraj";23;5925;14;5939;NA;96516;37;2021-06-09;-147061
2021-06-08;"Žilinský kraj";18;6615;16;6631;NA;96516;34;2021-06-08;-147098
2021-06-07;"Žilinský kraj";25;8534;21;8555;NA;96516;46;2021-06-07;-147132
2021-06-06;"Žilinský kraj";10;8056;27;8083;NA;96516;37;2021-06-06;-147178
2021-06-05;"Žilinský kraj";8;9175;10;9185;NA;96516;18;2021-06-05;-147215
2021-06-04;"Žilinský kraj";19;12260;34;12294;NA;96516;53;2021-06-04;-147233
2021-06-03;"Žilinský kraj";12;7033;33;7066;NA;96516;45;2021-06-03;-147286
2021-06-02;"Žilinský kraj";17;7103;28;7131;NA;96516;45;2021-06-02;-147331
2021-06-01;"Žilinský kraj";38;8285;46;8331;NA;96516;84;2021-06-01;-147376
2021-05-31;"Žilinský kraj";31;9616;59;9675;NA;96516;90;2021-05-31;-147460
2021-05-30;"Žilinský kraj";21;9025;35;9060;NA;96516;56;2021-05-30;-147550
2021-05-29;"Žilinský kraj";13;11195;23;11218;NA;96516;36;2021-05-29;-147606
2021-05-28;"Žilinský kraj";28;13277;30;13307;NA;96516;58;2021-05-28;-147642
2021-05-27;"Žilinský kraj";17;8267;39;8306;NA;96516;56;2021-05-27;-147700
2021-05-26;"Žilinský kraj";20;8329;25;8354;NA;96516;45;2021-05-26;-147756
2021-05-25;"Žilinský kraj";21;9624;38;9662;NA;96516;59;2021-05-25;-147801
2021-05-24;"Žilinský kraj";36;11487;57;11544;NA;96516;93;2021-05-24;-147860
2021-05-23;"Žilinský kraj";4;10923;56;10979;NA;96516;60;2021-05-23;-147953
2021-05-22;"Žilinský kraj";21;11893;28;11921;NA;96516;49;2021-05-22;-148013
2021-05-21;"Žilinský kraj";28;15654;50;15704;NA;96516;78;2021-05-21;-148062
2021-05-20;"Žilinský kraj";30;9616;30;9646;NA;96516;60;2021-05-20;-148140
2021-05-19;"Žilinský kraj";46;8693;41;8734;NA;96516;87;2021-05-19;-148200
2021-05-18;"Žilinský kraj";52;10609;44;10653;NA;96516;96;2021-05-18;-148287
2021-05-17;"Žilinský kraj";51;12676;84;12760;NA;96516;135;2021-05-17;-148383
2021-05-16;"Žilinský kraj";13;14114;42;14156;NA;96516;55;2021-05-16;-148518
2021-05-15;"Žilinský kraj";30;18404;35;18439;NA;96516;65;2021-05-15;-148573
2021-05-14;"Žilinský kraj";34;21205;82;21287;NA;96516;116;2021-05-14;-148638
2021-05-13;"Žilinský kraj";64;11865;51;11916;NA;96516;115;2021-05-13;-148754
2021-05-12;"Žilinský kraj";57;10337;51;10388;NA;96516;108;2021-05-12;-148869
2021-05-11;"Žilinský kraj";70;12174;51;12225;NA;96516;121;2021-05-11;-148977
2021-05-10;"Žilinský kraj";69;16182;72;16254;NA;96516;141;2021-05-10;-149098
2021-05-09;"Žilinský kraj";58;20385;77;20462;NA;96516;135;2021-05-09;-149239
2021-05-08;"Žilinský kraj";0;24133;63;24196;NA;96516;63;2021-05-08;-149374
2021-05-07;"Žilinský kraj";65;26522;87;26609;NA;96516;152;2021-05-07;-149437
2021-05-06;"Žilinský kraj";67;16615;72;16687;NA;96516;139;2021-05-06;-149589
2021-05-05;"Žilinský kraj";71;13096;73;13169;NA;96516;144;2021-05-05;-149728
2021-05-04;"Žilinský kraj";81;16749;80;16829;NA;96516;161;2021-05-04;-149872
2021-05-03;"Žilinský kraj";97;20391;111;20502;NA;96516;208;2021-05-03;-150033
2021-05-02;"Žilinský kraj";8;28886;64;28950;NA;96516;72;2021-05-02;-150241
2021-05-01;"Žilinský kraj";65;55053;105;55158;NA;96516;170;2021-05-01;-150313
2021-04-30;"Žilinský kraj";84;44000;117;44117;NA;96516;201;2021-04-30;-150483
2021-04-29;"Žilinský kraj";77;24566;101;24667;NA;96516;178;2021-04-29;-150684
2021-04-28;"Žilinský kraj";76;19214;91;19305;NA;96516;167;2021-04-28;-150862
2021-04-27;"Žilinský kraj";97;21805;110;21915;NA;96516;207;2021-04-27;-151029
2021-04-26;"Žilinský kraj";114;27412;136;27548;NA;96516;250;2021-04-26;-151236
2021-04-25;"Žilinský kraj";38;35750;82;35832;NA;96516;120;2021-04-25;-151486
2021-04-24;"Žilinský kraj";93;78854;157;79011;NA;96516;250;2021-04-24;-151606
2021-04-23;"Žilinský kraj";144;49440;153;49593;NA;96516;297;2021-04-23;-151856
2021-04-22;"Žilinský kraj";110;25247;132;25379;NA;96516;242;2021-04-22;-152153
2021-04-21;"Žilinský kraj";118;20616;145;20761;NA;96516;263;2021-04-21;-152395
2021-04-20;"Žilinský kraj";128;23873;136;24009;NA;96516;264;2021-04-20;-152658
2021-04-19;"Žilinský kraj";164;32773;210;32983;NA;96516;374;2021-04-19;-152922
2021-04-18;"Žilinský kraj";18;36767;91;36858;NA;96516;109;2021-04-18;-153296
2021-04-17;"Žilinský kraj";108;89377;156;89533;NA;96516;264;2021-04-17;-153405
2021-04-16;"Žilinský kraj";185;47847;208;48055;NA;96516;393;2021-04-16;-153669
2021-04-15;"Žilinský kraj";108;24830;130;24960;NA;96516;238;2021-04-15;-154062
2021-04-14;"Žilinský kraj";135;23145;145;23290;NA;96516;280;2021-04-14;-154300
2021-04-13;"Žilinský kraj";171;25050;135;25185;NA;96516;306;2021-04-13;-154580
2021-04-12;"Žilinský kraj";266;30794;189;30983;NA;96516;455;2021-04-12;-154886
2021-04-11;"Žilinský kraj";19;37126;107;37233;NA;96516;126;2021-04-11;-155341
2021-04-10;"Žilinský kraj";111;86284;237;86521;NA;96516;348;2021-04-10;-155467
2021-04-09;"Žilinský kraj";195;41973;206;42179;NA;96516;401;2021-04-09;-155815
2021-04-08;"Žilinský kraj";179;24434;141;24575;NA;96516;320;2021-04-08;-156216
2021-04-07;"Žilinský kraj";309;28651;174;28825;NA;96516;483;2021-04-07;-156536
2021-04-06;"Žilinský kraj";308;40107;301;40408;NA;96516;609;2021-04-06;-157019
2021-04-05;"Žilinský kraj";17;14747;140;14887;NA;96516;157;2021-04-05;-157628
2021-04-04;"Žilinský kraj";17;16284;69;16353;NA;96516;86;2021-04-04;-157785
2021-04-03;"Žilinský kraj";180;100699;403;101102;NA;96516;583;2021-04-03;-157871
2021-04-02;"Žilinský kraj";73;22411;83;22494;NA;96516;156;2021-04-02;-158454
2021-04-01;"Žilinský kraj";334;43264;240;43504;NA;96516;574;2021-04-01;-158610
2021-03-31;"Žilinský kraj";170;31635;247;31882;NA;96516;417;2021-03-31;-159184
2021-03-30;"Žilinský kraj";406;26323;243;26566;NA;96516;649;2021-03-30;-159601
2021-03-29;"Žilinský kraj";297;28029;268;28297;NA;96516;565;2021-03-29;-160250
2021-03-28;"Žilinský kraj";21;36206;239;36445;NA;96516;260;2021-03-28;-160815
2021-03-27;"Žilinský kraj";151;89107;353;89460;NA;96516;504;2021-03-27;-161075
2021-03-26;"Žilinský kraj";312;51757;330;52087;NA;96516;642;2021-03-26;-161579
2021-03-25;"Žilinský kraj";281;27619;214;27833;NA;96516;495;2021-03-25;-162221
2021-03-24;"Žilinský kraj";280;21268;260;21528;NA;96516;540;2021-03-24;-162716
2021-03-23;"Žilinský kraj";418;23193;278;23471;NA;96516;696;2021-03-23;-163256
2021-03-22;"Žilinský kraj";293;29289;314;29603;NA;96516;607;2021-03-22;-163952
2021-03-21;"Žilinský kraj";32;33705;227;33932;NA;96516;259;2021-03-21;-164559
2021-03-20;"Žilinský kraj";165;93015;497;93512;NA;96516;662;2021-03-20;-164818
2021-03-19;"Žilinský kraj";357;51988;414;52402;NA;96516;771;2021-03-19;-165480
2021-03-18;"Žilinský kraj";329;28459;294;28753;NA;96516;623;2021-03-18;-166251
2021-03-17;"Žilinský kraj";395;21919;269;22188;NA;96516;664;2021-03-17;-166874
2021-03-16;"Žilinský kraj";514;24341;317;24658;NA;96516;831;2021-03-16;-167538
2021-03-15;"Žilinský kraj";341;29613;419;30032;NA;96516;760;2021-03-15;-168369
2021-03-14;"Žilinský kraj";87;34121;267;34388;NA;96516;354;2021-03-14;-169129
2021-03-13;"Žilinský kraj";113;93386;581;93967;NA;96516;694;2021-03-13;-169483
2021-03-12;"Žilinský kraj";520;52329;411;52740;NA;96516;931;2021-03-12;-170177
2021-03-11;"Žilinský kraj";399;28189;302;28491;NA;96516;701;2021-03-11;-171108
2021-03-10;"Žilinský kraj";368;22414;378;22792;NA;96516;746;2021-03-10;-171809
2021-03-09;"Žilinský kraj";537;24857;316;25173;NA;96516;853;2021-03-09;-172555
2021-03-08;"Žilinský kraj";387;30873;458;31331;NA;96516;845;2021-03-08;-173408
2021-03-07;"Žilinský kraj";48;33469;290;33759;NA;96516;338;2021-03-07;-174253
2021-03-06;"Žilinský kraj";173;92410;589;92999;NA;96516;762;2021-03-06;-174591
2021-03-05;"Žilinský kraj";369;51987;484;52471;NA;96516;853;2021-03-05;-175353
2021-03-04;"Žilinský kraj";467;30037;377;30414;NA;96516;844;2021-03-04;-176206
2021-03-03;"Žilinský kraj";448;26261;394;26655;NA;96516;842;2021-03-03;-177050
2021-03-02;"Žilinský kraj";551;25913;378;26291;NA;96516;929;2021-03-02;-177892
2021-03-01;"Žilinský kraj";375;30498;441;30939;NA;96516;816;2021-03-01;-178821
2021-02-28;"Žilinský kraj";61;34802;327;35129;NA;96516;388;2021-02-28;-179637
2021-02-27;"Žilinský kraj";159;83781;639;84420;NA;96516;798;2021-02-27;-180025
2021-02-26;"Žilinský kraj";459;47500;508;48008;NA;96516;967;2021-02-26;-180823
2021-02-25;"Žilinský kraj";347;30879;393;31272;NA;96516;740;2021-02-25;-181790
2021-02-24;"Žilinský kraj";339;18760;395;19155;NA;96516;734;2021-02-24;-182530
2021-02-23;"Žilinský kraj";437;22172;418;22590;NA;96516;855;2021-02-23;-183264
2021-02-22;"Žilinský kraj";345;29270;438;29708;NA;96516;783;2021-02-22;-184119
2021-02-21;"Žilinský kraj";36;28686;322;29008;NA;96516;358;2021-02-21;-184902
2021-02-20;"Žilinský kraj";152;89944;671;90615;NA;96516;823;2021-02-20;-185260
2021-02-19;"Žilinský kraj";337;45541;417;45958;NA;96516;754;2021-02-19;-186083
2021-02-18;"Žilinský kraj";263;24662;337;24999;NA;96516;600;2021-02-18;-186837
2021-02-17;"Žilinský kraj";269;17932;355;18287;NA;96516;624;2021-02-17;-187437
2021-02-16;"Žilinský kraj";321;24298;325;24623;NA;96516;646;2021-02-16;-188061
2021-02-15;"Žilinský kraj";230;30420;311;30731;NA;96516;541;2021-02-15;-188707
2021-02-14;"Žilinský kraj";30;28723;231;28954;NA;96516;261;2021-02-14;-189248
2021-02-13;"Žilinský kraj";91;69638;453;70091;NA;96516;544;2021-02-13;-189509
2021-02-12;"Žilinský kraj";242;43338;336;43674;NA;96516;578;2021-02-12;-190053
2021-02-11;"Žilinský kraj";228;23521;300;23821;NA;96516;528;2021-02-11;-190631
2021-02-10;"Žilinský kraj";259;17894;267;18161;NA;96516;526;2021-02-10;-191159
2021-02-09;"Žilinský kraj";377;24784;274;25058;NA;96516;651;2021-02-09;-191685
2021-02-08;"Žilinský kraj";160;41375;390;41765;NA;96516;550;2021-02-08;-192336
2021-02-07;"Žilinský kraj";24;46446;252;46698;NA;96516;276;2021-02-07;-192886
2021-02-06;"Žilinský kraj";71;72880;367;73247;NA;96516;438;2021-02-06;-193162
2021-02-05;"Žilinský kraj";248;31869;323;32192;NA;96516;571;2021-02-05;-193600
2021-02-04;"Žilinský kraj";238;13240;258;13498;NA;96516;496;2021-02-04;-194171
2021-02-03;"Žilinský kraj";194;9186;255;9441;NA;96516;449;2021-02-03;-194667
2021-02-02;"Žilinský kraj";216;9280;272;9552;NA;96516;488;2021-02-02;-195116
2021-02-01;"Žilinský kraj";220;19690;370;20060;NA;96516;590;2021-02-01;-195604
2021-01-31;"Žilinský kraj";11;2652;27;2679;NA;96516;38;2021-01-31;-196194
2021-01-30;"Žilinský kraj";85;18447;187;18634;NA;96516;272;2021-01-30;-196232
2021-01-29;"Žilinský kraj";209;22891;304;23195;NA;96516;513;2021-01-29;-196504
2021-01-28;"Žilinský kraj";240;5533;172;5705;NA;96516;412;2021-01-28;-197017
2021-01-27;"Žilinský kraj";256;6725;119;6844;NA;96516;375;2021-01-27;-197429
2021-01-26;"Žilinský kraj";245;49781;348;50129;NA;96516;593;2021-01-26;-197804
2021-01-25;"Žilinský kraj";159;21245;150;21395;NA;96516;309;2021-01-25;-198397
2021-01-24;"Žilinský kraj";22;55835;268;56103;NA;96516;290;2021-01-24;-198706
2021-01-23;"Žilinský kraj";91;101730;444;102174;NA;96516;535;2021-01-23;-198996
2021-01-22;"Žilinský kraj";163;32160;237;32397;NA;96516;400;2021-01-22;-199531
2021-01-21;"Žilinský kraj";116;19828;181;20009;NA;96516;297;2021-01-21;-199931
2021-01-20;"Žilinský kraj";236;17126;159;17285;NA;96516;395;2021-01-20;-200228
2021-01-19;"Žilinský kraj";245;15730;285;16015;NA;96516;530;2021-01-19;-200623
2021-01-18;"Žilinský kraj";236;12685;326;13011;NA;96516;562;2021-01-18;-201153
2021-01-17;"Žilinský kraj";95;147;8;155;NA;96516;103;2021-01-17;-201715
2021-01-16;"Žilinský kraj";14;516;31;547;NA;96516;45;2021-01-16;-201818
2021-01-15;"Žilinský kraj";248;7486;209;7695;NA;96516;457;2021-01-15;-201863
2021-01-14;"Žilinský kraj";166;5319;239;5558;NA;96516;405;2021-01-14;-202320
2021-01-13;"Žilinský kraj";247;11263;557;11820;NA;96516;804;2021-01-13;-202725
2021-01-12;"Žilinský kraj";376;8410;385;8795;NA;96516;761;2021-01-12;-203529
2021-01-11;"Žilinský kraj";351;10058;465;10523;NA;96516;816;2021-01-11;-204290
2021-01-10;"Žilinský kraj";38;229;6;235;NA;96516;44;2021-01-10;-205106
2021-01-09;"Žilinský kraj";192;1282;60;1342;NA;96516;252;2021-01-09;-205150
2021-01-08;"Žilinský kraj";413;8721;462;9183;NA;96516;875;2021-01-08;-205402
2021-01-07;"Žilinský kraj";438;23407;1872;25279;NA;96516;2310;2021-01-07;-206277
2021-01-06;"Žilinský kraj";145;1076;67;1143;NA;96516;212;2021-01-06;-208587
2021-01-05;"Žilinský kraj";717;10227;796;11023;NA;96516;1513;2021-01-05;-208799
2021-01-04;"Žilinský kraj";479;9313;893;10206;NA;96516;1372;2021-01-04;-210312
2021-01-03;"Žilinský kraj";13;1006;107;1113;NA;96516;120;2021-01-03;-211684
2021-01-02;"Žilinský kraj";98;789;91;880;NA;96516;189;2021-01-02;-211804
2021-01-01;"Žilinský kraj";118;241;13;254;NA;96516;131;2021-01-01;-211993
2020-12-31;"Žilinský kraj";395;9626;784;10410;NA;96516;1179;2020-12-31;-212124
2020-12-30;"Žilinský kraj";1038;11781;823;12604;NA;96516;1861;2020-12-30;-213303
2020-12-29;"Žilinský kraj";256;10159;979;11138;NA;96516;1235;2020-12-29;-215164
2020-12-28;"Žilinský kraj";406;10704;976;11680;NA;96516;1382;2020-12-28;-216399
2020-12-27;"Žilinský kraj";40;684;94;778;NA;96516;134;2020-12-27;-217781
2020-12-26;"Žilinský kraj";135;593;48;641;NA;96516;183;2020-12-26;-217915
2020-12-25;"Žilinský kraj";66;83;9;92;NA;96516;75;2020-12-25;-218098
2020-12-24;"Žilinský kraj";643;667;55;722;NA;96516;698;2020-12-24;-218173
2020-12-23;"Žilinský kraj";228;16229;975;17204;NA;96516;1203;2020-12-23;-218871
2020-12-22;"Žilinský kraj";519;13483;988;14471;NA;96516;1507;2020-12-22;-220074
2020-12-21;"Žilinský kraj";444;12429;1078;13507;NA;96516;1522;2020-12-21;-221581
2020-12-20;"Žilinský kraj";36;598;80;678;NA;96516;116;2020-12-20;-223103
2020-12-19;"Žilinský kraj";208;1678;127;1805;NA;96516;335;2020-12-19;-223219
2020-12-18;"Žilinský kraj";333;6553;370;6923;NA;96516;703;2020-12-18;-223554
2020-12-17;"Žilinský kraj";500;3922;262;4184;NA;96516;762;2020-12-17;-224257
2020-12-16;"Žilinský kraj";333;3815;267;4082;NA;96516;600;2020-12-16;-225019
2020-12-15;"Žilinský kraj";528;3729;340;4069;NA;96516;868;2020-12-15;-225619
2020-12-14;"Žilinský kraj";321;3884;309;4193;NA;96516;630;2020-12-14;-226487
2020-12-13;"Žilinský kraj";26;494;66;560;NA;96516;92;2020-12-13;-227117
2020-12-12;"Žilinský kraj";95;767;46;813;NA;96516;141;2020-12-12;-227209
2020-12-11;"Žilinský kraj";455;3938;227;4165;NA;96516;682;2020-12-11;-227350
2020-12-10;"Žilinský kraj";166;9129;838;9967;NA;96516;1004;2020-12-10;-228032
2020-12-09;"Žilinský kraj";392;2169;132;2301;NA;96516;524;2020-12-09;-229036
2020-12-08;"Žilinský kraj";331;3127;101;3228;NA;96516;432;2020-12-08;-229560
2020-12-07;"Žilinský kraj";348;2746;162;2908;NA;96516;510;2020-12-07;-229992
2020-12-06;"Žilinský kraj";15;128;6;134;NA;96516;21;2020-12-06;-230502
2020-12-05;"Žilinský kraj";98;781;41;822;NA;96516;139;2020-12-05;-230523
2020-12-04;"Žilinský kraj";228;3091;107;3198;NA;96516;335;2020-12-04;-230662
2020-12-03;"Žilinský kraj";237;1609;115;1724;NA;96516;352;2020-12-03;-230997
2020-12-02;"Žilinský kraj";181;1710;94;1804;NA;96516;275;2020-12-02;-231349
2020-12-01;"Žilinský kraj";209;6239;284;6523;NA;96516;493;2020-12-01;-231624
2020-11-30;"Žilinský kraj";203;5326;305;5631;NA;96516;508;2020-11-30;-232117
2020-11-29;"Žilinský kraj";18;81;7;88;NA;96516;25;2020-11-29;-232625
2020-11-28;"Žilinský kraj";99;349;15;364;NA;96516;114;2020-11-28;-232650
2020-11-27;"Žilinský kraj";218;904;46;950;NA;96516;264;2020-11-27;-232764
2020-11-26;"Žilinský kraj";190;1041;54;1095;NA;96516;244;2020-11-26;-233028
2020-11-25;"Žilinský kraj";225;1217;49;1266;NA;96516;274;2020-11-25;-233272
2020-11-24;"Žilinský kraj";213;2139;67;2206;NA;96516;280;2020-11-24;-233546
2020-11-23;"Žilinský kraj";170;759;44;803;NA;96516;214;2020-11-23;-233826
2020-11-22;"Žilinský kraj";11;67;2;69;NA;96516;13;2020-11-22;-234040
2020-11-21;"Žilinský kraj";61;505;20;525;NA;96516;81;2020-11-21;-234053
2020-11-20;"Žilinský kraj";251;1074;45;1119;NA;96516;296;2020-11-20;-234134
2020-11-19;"Žilinský kraj";252;752;61;813;NA;96516;313;2020-11-19;-234430
2020-11-18;"Žilinský kraj";346;348;15;363;NA;96516;361;2020-11-18;-234743
2020-11-17;"Žilinský kraj";123;490;15;505;NA;96516;138;2020-11-17;-235104
2020-11-16;"Žilinský kraj";227;247;15;262;NA;96516;242;2020-11-16;-235242
2020-11-15;"Žilinský kraj";63;13;0;13;NA;96516;63;2020-11-15;-235484
2020-11-14;"Žilinský kraj";189;1038;11;1049;NA;96516;200;2020-11-14;-235547
2020-11-13;"Žilinský kraj";181;125;9;134;NA;96516;190;2020-11-13;-235747
2020-11-12;"Žilinský kraj";334;79;2;81;NA;96516;336;2020-11-12;-235937
2020-11-11;"Žilinský kraj";489;147;10;157;NA;96516;499;2020-11-11;-236273
2020-11-10;"Žilinský kraj";374;519;9;528;NA;96516;383;2020-11-10;-236772
2020-11-09;"Žilinský kraj";143;2335;30;2365;NA;96516;173;2020-11-09;-237155
2020-11-08;"Žilinský kraj";59;2538;37;2575;NA;96516;96;2020-11-08;-237328
2020-11-07;"Žilinský kraj";312;8175;88;8263;NA;96516;400;2020-11-07;-237424
2020-11-06;"Žilinský kraj";503;4090;38;4128;NA;96516;541;2020-11-06;-237824
2020-11-05;"Žilinský kraj";473;64;4;68;NA;96516;477;2020-11-05;-238365
2020-11-04;"Žilinský kraj";423;178;10;188;NA;96516;433;2020-11-04;-238842
2020-11-03;"Žilinský kraj";688;889;16;905;NA;96516;704;2020-11-03;-239275
2020-11-02;"Žilinský kraj";472;1043;39;1082;NA;96516;511;2020-11-02;-239979
2020-11-01;"Žilinský kraj";349;5096;130;5226;NA;96516;479;2020-11-01;-240490
2020-10-31;"Žilinský kraj";661;7963;203;8166;NA;96516;864;2020-10-31;-240969
2020-10-30;"Žilinský kraj";529;2575;61;2636;NA;96516;590;2020-10-30;-241833
2020-10-29;"Žilinský kraj";740;503;17;520;NA;96516;757;2020-10-29;-242423
2020-10-28;"Žilinský kraj";635;105;11;116;NA;96516;646;2020-10-28;-243180
2020-10-27;"Žilinský kraj";355;154;24;178;NA;96516;379;2020-10-27;-243826
2020-10-26;"Žilinský kraj";148;117;28;145;NA;96516;176;2020-10-26;-244205
2020-10-25;"Žilinský kraj";436;0;0;0;NA;96516;436;2020-10-25;-244381
2020-10-24;"Žilinský kraj";803;0;0;0;NA;96516;803;2020-10-24;-244817
2020-10-23;"Žilinský kraj";659;102;13;115;NA;96516;672;2020-10-23;-245620
2020-10-22;"Žilinský kraj";525;33;3;36;NA;96516;528;2020-10-22;-246292
2020-10-21;"Žilinský kraj";478;74;14;88;NA;96516;492;2020-10-21;-246820
2020-10-20;"Žilinský kraj";524;127;8;135;NA;96516;532;2020-10-20;-247312
2020-10-19;"Žilinský kraj";70;80;12;92;NA;96516;82;2020-10-19;-247844
2020-10-18;"Žilinský kraj";159;0;0;0;NA;96516;159;2020-10-18;-247926
2020-10-17;"Žilinský kraj";509;0;0;0;NA;96516;509;2020-10-17;-248085
2020-10-16;"Žilinský kraj";603;51;9;60;NA;96516;612;2020-10-16;-248594
2020-10-15;"Žilinský kraj";679;61;3;64;NA;96516;682;2020-10-15;-249206
2020-10-14;"Žilinský kraj";523;269;6;275;NA;96516;529;2020-10-14;-249888
2020-10-13;"Žilinský kraj";367;458;40;498;NA;96516;407;2020-10-13;-250417
2020-10-12;"Žilinský kraj";62;0;0;0;NA;96516;62;2020-10-12;-250824
2020-10-11;"Žilinský kraj";50;0;0;0;NA;96516;50;2020-10-11;-250886
2020-10-10;"Žilinský kraj";213;0;0;0;NA;96516;213;2020-10-10;-250936
2020-10-09;"Žilinský kraj";543;0;0;0;NA;96516;543;2020-10-09;-251149
2020-10-08;"Žilinský kraj";238;0;0;0;NA;96516;238;2020-10-08;-251692
2020-10-07;"Žilinský kraj";168;0;0;0;NA;96516;168;2020-10-07;-251930
2020-10-06;"Žilinský kraj";233;0;0;0;NA;96516;233;2020-10-06;-252098
2020-10-05;"Žilinský kraj";33;0;0;0;NA;96516;33;2020-10-05;-252331
2020-10-04;"Žilinský kraj";35;0;0;0;NA;96516;35;2020-10-04;-252364
2020-10-03;"Žilinský kraj";155;0;0;0;NA;96516;155;2020-10-03;-252399
2020-10-02;"Žilinský kraj";105;0;0;0;NA;96516;105;2020-10-02;-252554
2020-10-01;"Žilinský kraj";147;0;0;0;NA;96516;147;2020-10-01;-252659
2020-09-30;"Žilinský kraj";163;0;0;0;NA;96516;163;2020-09-30;-252806
2020-09-29;"Žilinský kraj";105;0;0;0;NA;96516;105;2020-09-29;-252969
2020-09-28;"Žilinský kraj";34;0;0;0;NA;96516;34;2020-09-28;-253074
2020-09-27;"Žilinský kraj";108;0;0;0;NA;96516;108;2020-09-27;-253108
2020-09-26;"Žilinský kraj";96;0;0;0;NA;96516;96;2020-09-26;-253216
2020-09-25;"Žilinský kraj";69;0;0;0;NA;96516;69;2020-09-25;-253312
2020-09-24;"Žilinský kraj";100;0;0;0;NA;96516;100;2020-09-24;-253381
2020-09-23;"Žilinský kraj";65;0;0;0;NA;96516;65;2020-09-23;-253481
2020-09-22;"Žilinský kraj";65;0;0;0;NA;96516;65;2020-09-22;-253546
2020-09-21;"Žilinský kraj";47;0;0;0;NA;96516;47;2020-09-21;-253611
2020-09-20;"Žilinský kraj";4;0;0;0;NA;96516;4;2020-09-20;-253658
2020-09-19;"Žilinský kraj";6;0;0;0;NA;96516;6;2020-09-19;-253662
2020-09-18;"Žilinský kraj";82;0;0;0;NA;96516;82;2020-09-18;-253668
2020-09-17;"Žilinský kraj";30;0;0;0;NA;96516;30;2020-09-17;-253750
2020-09-16;"Žilinský kraj";34;0;0;0;NA;96516;34;2020-09-16;-253780
2020-09-15;"Žilinský kraj";12;0;0;0;NA;96516;12;2020-09-15;-253814
2020-09-14;"Žilinský kraj";39;0;0;0;NA;96516;39;2020-09-14;-253826
2020-09-13;"Žilinský kraj";6;0;0;0;NA;96516;6;2020-09-13;-253865
2020-09-12;"Žilinský kraj";4;0;0;0;NA;96516;4;2020-09-12;-253871
2020-09-11;"Žilinský kraj";31;0;0;0;NA;96516;31;2020-09-11;-253875
2020-09-10;"Žilinský kraj";31;12;0;12;NA;96516;31;2020-09-10;-253906
2020-09-09;"Žilinský kraj";23;0;0;0;NA;96516;23;2020-09-09;-253937
2020-09-08;"Žilinský kraj";25;0;0;0;NA;96516;25;2020-09-08;-253960
2020-09-07;"Žilinský kraj";11;0;0;0;NA;96516;11;2020-09-07;-253985
2020-09-06;"Žilinský kraj";0;0;0;0;NA;96516;0;2020-09-06;-253996
2020-09-05;"Žilinský kraj";2;0;0;0;NA;96516;2;2020-09-05;-253996
2020-09-04;"Žilinský kraj";33;0;0;0;NA;96516;33;2020-09-04;-253998
2020-09-03;"Žilinský kraj";18;0;0;0;NA;96516;18;2020-09-03;-254031
2020-09-02;"Žilinský kraj";16;0;0;0;NA;96516;16;2020-09-02;-254049
2020-09-01;"Žilinský kraj";4;0;0;0;NA;96516;4;2020-09-01;-254065
2020-08-31;"Žilinský kraj";5;0;0;0;NA;96516;5;2020-08-31;-254069
2020-08-30;"Žilinský kraj";3;0;0;0;NA;96516;3;2020-08-30;-254074
2020-08-29;"Žilinský kraj";5;0;0;0;NA;96516;5;2020-08-29;-254077
2020-08-28;"Žilinský kraj";13;0;0;0;NA;96516;13;2020-08-28;-254082
2020-08-27;"Žilinský kraj";18;0;0;0;NA;96516;18;2020-08-27;-254095
2020-08-26;"Žilinský kraj";8;0;0;0;NA;96516;8;2020-08-26;-254113
2020-08-25;"Žilinský kraj";2;0;0;0;NA;96516;2;2020-08-25;-254121
2020-08-24;"Žilinský kraj";5;0;0;0;NA;96516;5;2020-08-24;-254123
2020-08-23;"Žilinský kraj";0;0;0;0;NA;96516;0;2020-08-23;-254128
2020-08-22;"Žilinský kraj";0;0;0;0;NA;96516;0;2020-08-22;-254128
2020-08-21;"Žilinský kraj";10;0;0;0;NA;96516;10;2020-08-21;-254128
2020-08-20;"Žilinský kraj";13;0;0;0;NA;96516;13;2020-08-20;-254138
2020-08-19;"Žilinský kraj";7;0;0;0;NA;96516;7;2020-08-19;-254151
2020-08-18;"Žilinský kraj";9;0;0;0;NA;96516;9;2020-08-18;-254158
2020-08-17;"Žilinský kraj";1;0;0;0;NA;96516;1;2020-08-17;-254167
2020-08-16;"Žilinský kraj";0;0;0;0;NA;96516;0;2020-08-16;-254168
2020-08-15;"Žilinský kraj";0;0;0;0;NA;96516;0;2020-08-15;-254168
2020-08-14;"Žilinský kraj";4;0;0;0;NA;96516;4;2020-08-14;-254168
2020-08-13;"Žilinský kraj";2;0;0;0;NA;96516;2;2020-08-13;-254172
2020-08-12;"Žilinský kraj";0;0;0;0;NA;96516;0;2020-08-12;-254174
2020-08-11;"Žilinský kraj";4;0;0;0;NA;96516;4;2020-08-11;-254174
2020-08-10;"Žilinský kraj";1;0;0;0;NA;96516;1;2020-08-10;-254178
2020-08-09;"Žilinský kraj";0;0;0;0;NA;96516;0;2020-08-09;-254179
2020-08-08;"Žilinský kraj";3;0;0;0;NA;96516;3;2020-08-08;-254179
2020-08-07;"Žilinský kraj";8;0;0;0;NA;96516;8;2020-08-07;-254182
2020-08-06;"Žilinský kraj";1;0;0;0;NA;96516;1;2020-08-06;-254190
2020-08-05;"Žilinský kraj";1;0;0;0;NA;96516;1;2020-08-05;-254191
2020-08-04;"Žilinský kraj";2;0;0;0;NA;96516;2;2020-08-04;-254192
2020-08-03;"Žilinský kraj";0;0;0;0;NA;96516;0;2020-08-03;-254194
2020-08-02;"Žilinský kraj";1;0;0;0;NA;96516;1;2020-08-02;-254194
2020-08-01;"Žilinský kraj";0;0;0;0;NA;96516;0;2020-08-01;-254195
2020-07-31;"Žilinský kraj";4;0;0;0;NA;96516;4;2020-07-31;-254195
2020-07-30;"Žilinský kraj";2;0;0;0;NA;96516;2;2020-07-30;-254199
2020-07-29;"Žilinský kraj";2;0;0;0;NA;96516;2;2020-07-29;-254201
2020-07-28;"Žilinský kraj";4;0;0;0;NA;96516;4;2020-07-28;-254203
2020-07-27;"Žilinský kraj";6;0;0;0;NA;96516;6;2020-07-27;-254207
2020-07-26;"Žilinský kraj";0;0;0;0;NA;96516;0;2020-07-26;-254213
2020-07-25;"Žilinský kraj";0;0;0;0;NA;96516;0;2020-07-25;-254213
2020-07-24;"Žilinský kraj";2;0;0;0;NA;96516;2;2020-07-24;-254213
2020-07-23;"Žilinský kraj";0;0;0;0;NA;96516;0;2020-07-23;-254215
2020-07-22;"Žilinský kraj";1;0;0;0;NA;96516;1;2020-07-22;-254215
2020-07-21;"Žilinský kraj";2;0;0;0;NA;96516;2;2020-07-21;-254216
2020-07-20;"Žilinský kraj";3;0;0;0;NA;96516;3;2020-07-20;-254218
2020-07-19;"Žilinský kraj";0;0;0;0;NA;96516;0;2020-07-19;-254221
2020-07-18;"Žilinský kraj";0;0;0;0;NA;96516;0;2020-07-18;-254221
2020-07-17;"Žilinský kraj";2;0;0;0;NA;96516;2;2020-07-17;-254221
2020-07-16;"Žilinský kraj";2;0;0;0;NA;96516;2;2020-07-16;-254223
2020-07-15;"Žilinský kraj";2;0;0;0;NA;96516;2;2020-07-15;-254225
2020-07-14;"Žilinský kraj";1;0;0;0;NA;96516;1;2020-07-14;-254227
2020-07-13;"Žilinský kraj";0;0;0;0;NA;96516;0;2020-07-13;-254228
2020-07-12;"Žilinský kraj";0;0;0;0;NA;96516;0;2020-07-12;-254228
2020-07-11;"Žilinský kraj";2;0;0;0;NA;96516;2;2020-07-11;-254228
2020-07-10;"Žilinský kraj";3;0;0;0;NA;96516;3;2020-07-10;-254230
2020-07-09;"Žilinský kraj";2;0;0;0;NA;96516;2;2020-07-09;-254233
2020-07-08;"Žilinský kraj";10;0;0;0;NA;96516;10;2020-07-08;-254235
2020-07-07;"Žilinský kraj";7;0;0;0;NA;96516;7;2020-07-07;-254245
2020-07-06;"Žilinský kraj";0;0;0;0;NA;96516;0;2020-07-06;-254252
2020-07-05;"Žilinský kraj";0;0;0;0;NA;96516;0;2020-07-05;-254252
2020-07-04;"Žilinský kraj";10;0;0;0;NA;96516;10;2020-07-04;-254252
2020-07-03;"Žilinský kraj";18;0;0;0;NA;96516;18;2020-07-03;-254262
2020-07-02;"Žilinský kraj";7;0;0;0;NA;96516;7;2020-07-02;-254280
2020-07-01;"Žilinský kraj";0;0;0;0;NA;96516;0;2020-07-01;-254287
2020-06-30;"Žilinský kraj";4;0;0;0;NA;96516;4;2020-06-30;-254287
2020-06-29;"Žilinský kraj";0;0;0;0;NA;96516;0;2020-06-29;-254291
2020-06-28;"Žilinský kraj";1;0;0;0;NA;96516;1;2020-06-28;-254291
2020-06-27;"Žilinský kraj";3;0;0;0;NA;96516;3;2020-06-27;-254292
2020-06-26;"Žilinský kraj";5;0;0;0;NA;96516;5;2020-06-26;-254295
2020-06-25;"Žilinský kraj";7;0;0;0;NA;96516;7;2020-06-25;-254300
2020-06-24;"Žilinský kraj";11;0;0;0;NA;96516;11;2020-06-24;-254307
2020-06-23;"Žilinský kraj";9;0;0;0;NA;96516;9;2020-06-23;-254318
2020-06-22;"Žilinský kraj";0;0;0;0;NA;96516;0;2020-06-22;-254327
2020-06-21;"Žilinský kraj";1;0;0;0;NA;96516;1;2020-06-21;-254327
2020-06-20;"Žilinský kraj";1;0;0;0;NA;96516;1;2020-06-20;-254328
2020-06-19;"Žilinský kraj";4;0;0;0;NA;96516;4;2020-06-19;-254329
2020-06-18;"Žilinský kraj";1;0;0;0;NA;96516;1;2020-06-18;-254333
2020-06-17;"Žilinský kraj";0;0;0;0;NA;96516;0;2020-06-17;-254334
2020-06-16;"Žilinský kraj";1;0;0;0;NA;96516;1;2020-06-16;-254334
2020-06-14;"Žilinský kraj";0;0;0;0;NA;96516;0;2020-06-14;-254335
2020-06-13;"Žilinský kraj";0;0;0;0;NA;96516;0;2020-06-13;-254335
2020-06-12;"Žilinský kraj";0;0;0;0;NA;96516;0;2020-06-12;-254335
2020-06-11;"Žilinský kraj";0;0;0;0;NA;96516;0;2020-06-11;-254335
2020-06-10;"Žilinský kraj";0;0;0;0;NA;96516;0;2020-06-10;-254335
2020-06-09;"Žilinský kraj";1;0;0;0;NA;96516;1;2020-06-09;-254335
2020-06-08;"Žilinský kraj";0;0;0;0;NA;96516;0;2020-06-08;-254336
2020-06-07;"Žilinský kraj";0;0;0;0;NA;96516;0;2020-06-07;-254336
2020-06-05;"Žilinský kraj";0;0;0;0;NA;96516;0;2020-06-05;-254336
2020-06-03;"Žilinský kraj";0;0;0;0;NA;96516;0;2020-06-03;-254336
2020-06-02;"Žilinský kraj";0;0;0;0;NA;96516;0;2020-06-02;-254336
2020-05-31;"Žilinský kraj";0;0;0;0;NA;96516;0;2020-05-31;-254336
2020-05-29;"Žilinský kraj";0;0;0;0;NA;96516;0;2020-05-29;-254336
2020-05-27;"Žilinský kraj";1;0;0;0;NA;96516;1;2020-05-27;-254336
2020-05-26;"Žilinský kraj";1;0;0;0;NA;96516;1;2020-05-26;-254337
2020-05-25;"Žilinský kraj";0;0;0;0;NA;96516;0;2020-05-25;-254338
2020-05-24;"Žilinský kraj";0;0;0;0;NA;96516;0;2020-05-24;-254338
2020-05-23;"Žilinský kraj";0;0;0;0;NA;96516;0;2020-05-23;-254338
2020-05-22;"Žilinský kraj";0;0;0;0;NA;96516;0;2020-05-22;-254338
2020-05-21;"Žilinský kraj";0;0;0;0;NA;96516;0;2020-05-21;-254338
2020-05-20;"Žilinský kraj";0;0;0;0;NA;96516;0;2020-05-20;-254338
2020-05-19;"Žilinský kraj";1;0;0;0;NA;96516;1;2020-05-19;-254338
2020-05-17;"Žilinský kraj";0;0;0;0;NA;96516;0;2020-05-17;-254339
2020-05-16;"Žilinský kraj";0;0;0;0;NA;96516;0;2020-05-16;-254339
2020-05-15;"Žilinský kraj";0;0;0;0;NA;96516;0;2020-05-15;-254339
2020-05-14;"Žilinský kraj";0;0;0;0;NA;96516;0;2020-05-14;-254339
2020-05-13;"Žilinský kraj";0;0;0;0;NA;96516;0;2020-05-13;-254339
2020-05-12;"Žilinský kraj";0;0;0;0;NA;96516;0;2020-05-12;-254339
2020-05-11;"Žilinský kraj";0;0;0;0;NA;96516;0;2020-05-11;-254339
2020-05-09;"Žilinský kraj";0;0;0;0;NA;96516;0;2020-05-09;-254339
2020-05-07;"Žilinský kraj";0;0;0;0;NA;96516;0;2020-05-07;-254339
2020-05-06;"Žilinský kraj";2;0;0;0;NA;96516;2;2020-05-06;-254339
2020-05-05;"Žilinský kraj";3;0;0;0;NA;96516;3;2020-05-05;-254341
2020-05-04;"Žilinský kraj";3;0;0;0;NA;96516;3;2020-05-04;-254344
2020-05-03;"Žilinský kraj";1;0;0;0;NA;96516;1;2020-05-03;-254347
2020-05-02;"Žilinský kraj";0;0;0;0;NA;96516;0;2020-05-02;-254348
2020-05-01;"Žilinský kraj";1;0;0;0;NA;96516;1;2020-05-01;-254348
2020-04-30;"Žilinský kraj";0;0;0;0;NA;96516;0;2020-04-30;-254349
2020-04-29;"Žilinský kraj";0;0;0;0;NA;96516;0;2020-04-29;-254349
2020-04-28;"Žilinský kraj";0;0;0;0;NA;96516;0;2020-04-28;-254349
2020-04-27;"Žilinský kraj";0;0;0;0;NA;96516;0;2020-04-27;-254349
2020-04-26;"Žilinský kraj";0;0;0;0;NA;96516;0;2020-04-26;-254349
2020-04-25;"Žilinský kraj";2;0;0;0;NA;96516;2;2020-04-25;-254349
2020-04-24;"Žilinský kraj";1;0;0;0;NA;96516;1;2020-04-24;-254351
2020-04-23;"Žilinský kraj";2;0;0;0;NA;96516;2;2020-04-23;-254352
2020-04-22;"Žilinský kraj";9;0;0;0;NA;96516;9;2020-04-22;-254354
2020-04-21;"Žilinský kraj";1;0;0;0;NA;96516;1;2020-04-21;-254363
2020-04-20;"Žilinský kraj";4;0;0;0;NA;96516;4;2020-04-20;-254364
2020-04-19;"Žilinský kraj";0;0;0;0;NA;96516;0;2020-04-19;-254368
2020-04-18;"Žilinský kraj";49;0;0;0;NA;96516;49;2020-04-18;-254368
2020-04-17;"Žilinský kraj";3;0;0;0;NA;96516;3;2020-04-17;-254417
2020-04-16;"Žilinský kraj";4;0;0;0;NA;96516;4;2020-04-16;-254420
2020-04-15;"Žilinský kraj";7;0;0;0;NA;96516;7;2020-04-15;-254424
2020-04-14;"Žilinský kraj";1;0;0;0;NA;96516;1;2020-04-14;-254431
2020-04-13;"Žilinský kraj";2;0;0;0;NA;96516;2;2020-04-13;-254432
2020-04-12;"Žilinský kraj";5;0;0;0;NA;96516;5;2020-04-12;-254434
2020-04-11;"Žilinský kraj";2;0;0;0;NA;96516;2;2020-04-11;-254439
2020-04-10;"Žilinský kraj";1;0;0;0;NA;96516;1;2020-04-10;-254441
2020-04-09;"Žilinský kraj";1;0;0;0;NA;96516;1;2020-04-09;-254442
2020-04-08;"Žilinský kraj";3;0;0;0;NA;96516;3;2020-04-08;-254443
2020-04-07;"Žilinský kraj";5;0;0;0;NA;96516;5;2020-04-07;-254446
2020-04-06;"Žilinský kraj";6;0;0;0;NA;96516;6;2020-04-06;-254451
2020-04-05;"Žilinský kraj";8;0;0;0;NA;96516;8;2020-04-05;-254457
2020-04-04;"Žilinský kraj";0;0;0;0;NA;96516;0;2020-04-04;-254465
2020-04-03;"Žilinský kraj";3;0;0;0;NA;96516;3;2020-04-03;-254465
2020-04-02;"Žilinský kraj";5;0;0;0;NA;96516;5;2020-04-02;-254468
2020-04-01;"Žilinský kraj";4;0;0;0;NA;96516;4;2020-04-01;-254473
2020-03-31;"Žilinský kraj";1;0;0;0;NA;96516;1;2020-03-31;-254477
2020-03-30;"Žilinský kraj";3;0;0;0;NA;96516;3;2020-03-30;-254478
2020-03-29;"Žilinský kraj";0;0;0;0;NA;96516;0;2020-03-29;-254481
2020-03-28;"Žilinský kraj";1;0;0;0;NA;96516;1;2020-03-28;-254481
2020-03-27;"Žilinský kraj";9;0;0;0;NA;96516;9;2020-03-27;-254482
2020-03-26;"Žilinský kraj";4;0;0;0;NA;96516;4;2020-03-26;-254491
2020-03-25;"Žilinský kraj";1;0;0;0;NA;96516;1;2020-03-25;-254495
2020-03-24;"Žilinský kraj";2;0;0;0;NA;96516;2;2020-03-24;-254496
2020-03-23;"Žilinský kraj";3;0;0;0;NA;96516;3;2020-03-23;-254498
2020-03-22;"Žilinský kraj";1;0;0;0;NA;96516;1;2020-03-22;-254501
2020-03-21;"Žilinský kraj";2;0;0;0;NA;96516;2;2020-03-21;-254502
2020-03-20;"Žilinský kraj";4;0;0;0;NA;96516;4;2020-03-20;-254504
2020-03-19;"Žilinský kraj";2;0;0;0;NA;96516;2;2020-03-19;-254508
2020-03-18;"Žilinský kraj";1;0;0;0;NA;96516;1;2020-03-18;-254510
2020-03-17;"Žilinský kraj";5;0;0;0;NA;96516;5;2020-03-17;-254511
2020-03-16;"Žilinský kraj";1;0;0;0;NA;96516;1;2020-03-16;-254516
2020-03-15;"Žilinský kraj";2;0;0;0;NA;96516;2;2020-03-15;-254517
2020-03-14;"Žilinský kraj";1;0;0;0;NA;96516;1;2020-03-14;-254519
2020-03-13;"Žilinský kraj";5;0;0;0;NA;96516;5;2020-03-13;-254520
2020-03-12;"Žilinský kraj";1;0;0;0;NA;96516;1;2020-03-12;-254525
2020-03-11;"Žilinský kraj";0;0;0;0;NA;96516;0;2020-03-11;-254526
2020-03-09;"Žilinský kraj";1;0;0;0;NA;96516;1;2020-03-09;-254526
2020-03-08;"Žilinský kraj";0;0;0;0;NA;96516;0;2020-03-08;-254527
2020-03-07;"Žilinský kraj";0;0;0;0;NA;96516;0;2020-03-07;-254527
2020-03-06;"Žilinský kraj";0;0;0;0;NA;96516;0;2020-03-06;-254527
